year,team,conference,division,total.games,total.wins,total.losses,total.ties,conferenceGames.games,conferenceGames.wins,conferenceGames.losses,conferenceGames.ties,homeGames.games,homeGames.wins,homeGames.losses,homeGames.ties,awayGames.games,awayGames.wins,awayGames.losses,awayGames.ties
2020,Air Force,Mountain West,Mountain,6,3,3,0,4,2,2,0,3,2,1,0,3,1,2,0
2020,Akron,Mid-American,East,6,1,5,0,6,1,5,0,3,1,2,0,3,0,3,0
2020,Alabama,SEC,West,13,13,0,0,11,11,0,0,5,5,0,0,5,5,0,0
2020,Appalachian State,Sun Belt,,12,9,3,0,8,6,2,0,6,5,1,0,5,3,2,0
2020,Arizona,Pac-12,South,5,0,5,0,5,0,5,0,3,0,3,0,2,0,2,0
2020,Arizona State,Pac-12,South,4,2,2,0,4,2,2,0,1,0,1,0,3,2,1,0
2020,Arkansas,SEC,West,10,3,7,0,10,3,7,0,5,2,3,0,5,1,4,0
2020,Arkansas State,Sun Belt,,11,4,7,0,8,2,6,0,5,3,2,0,6,1,5,0
2020,Army,FBS Independents,,12,9,3,0,0,0,0,0,7,7,0,0,3,1,2,0
2020,Auburn,SEC,West,11,6,5,0,10,6,4,0,5,4,1,0,5,2,3,0
2020,Ball State,Mid-American,West,8,7,1,0,7,6,1,0,3,3,0,0,3,2,1,0
2020,Baylor,Big 12,,9,2,7,0,9,2,7,0,4,2,2,0,5,0,5,0
2020,Boise State,Mountain West,Mountain,7,5,2,0,6,5,1,0,3,2,1,0,3,3,0,0
2020,Boston College,ACC,Atlantic,11,6,5,0,10,5,5,0,6,4,2,0,5,2,3,0
2020,Bowling Green,Mid-American,East,5,0,5,0,5,0,5,0,2,0,2,0,3,0,3,0
2020,Buffalo,Mid-American,East,7,6,1,0,6,5,1,0,3,3,0,0,2,2,0,0
2020,BYU,FBS Independents,,12,11,1,0,0,0,0,0,7,7,0,0,4,3,1,0
2020,California,Pac-12,North,4,1,3,0,4,1,3,0,2,1,1,0,2,0,2,0
2020,Central Michigan,Mid-American,West,6,3,3,0,6,3,3,0,3,1,2,0,3,2,1,0
2020,Charlotte,Conference USA,East,6,2,4,0,4,2,2,0,2,1,1,0,4,1,3,0
2020,Cincinnati,American Athletic,East,10,9,1,0,7,7,0,0,7,7,0,0,2,2,0,0
2020,Clemson,ACC,Atlantic,12,10,2,0,10,9,1,0,6,6,0,0,4,3,1,0
2020,Coastal Carolina,Sun Belt,,12,11,1,0,8,8,0,0,6,6,0,0,5,5,0,0
2020,Colorado,Pac-12,South,6,4,2,0,4,3,1,0,3,2,1,0,2,2,0,0
2020,Colorado State,Mountain West,Mountain,4,1,3,0,4,1,3,0,1,1,0,0,3,0,3,0
2020,Duke,ACC,Coastal,11,2,9,0,10,1,9,0,5,1,4,0,6,1,5,0
2020,East Carolina,American Athletic,East,9,3,6,0,8,3,5,0,4,1,3,0,5,2,3,0
2020,Eastern Michigan,Mid-American,West,6,2,4,0,6,2,4,0,3,1,2,0,3,1,2,0
2020,Florida,SEC,East,12,8,4,0,11,8,3,0,5,4,1,0,4,3,1,0
2020,Florida Atlantic,Conference USA,East,9,5,4,0,6,4,2,0,4,4,0,0,4,1,3,0
2020,Florida International,Conference USA,East,5,0,5,0,3,0,3,0,3,0,3,0,2,0,2,0
2020,Florida State,ACC,Atlantic,9,3,6,0,8,2,6,0,5,3,2,0,4,0,4,0
2020,Fresno State,Mountain West,West,6,3,3,0,6,3,3,0,2,1,1,0,4,2,2,0
2020,Georgia,SEC,East,10,8,2,0,9,7,2,0,3,3,0,0,5,4,1,0
2020,Georgia Southern,Sun Belt,,13,8,5,0,8,4,4,0,7,6,1,0,5,1,4,0
2020,Georgia State,Sun Belt,,10,6,4,0,8,4,4,0,5,3,2,0,4,2,2,0
2020,Georgia Tech,ACC,Coastal,10,3,7,0,9,3,6,0,6,2,4,0,4,1,3,0
2020,Hawai'i,Mountain West,West,9,5,4,0,8,4,4,0,4,3,1,0,4,1,3,0
2020,Houston,American Athletic,West,8,3,5,0,6,3,3,0,4,2,2,0,3,1,2,0
2020,Illinois,Big Ten,West,8,2,6,0,8,2,6,0,3,0,3,0,5,2,3,0
2020,Indiana,Big Ten,East,8,6,2,0,7,6,1,0,3,3,0,0,4,3,1,0
2020,Iowa,Big Ten,West,8,6,2,0,8,6,2,0,4,3,1,0,4,3,1,0
2020,Iowa State,Big 12,,12,9,3,0,10,8,2,0,6,5,1,0,4,3,1,0
2020,Kansas,Big 12,,9,0,9,0,8,0,8,0,4,0,4,0,5,0,5,0
2020,Kansas State,Big 12,,10,4,6,0,9,4,5,0,5,2,3,0,5,2,3,0
2020,Kent State,Mid-American,East,4,3,1,0,4,3,1,0,2,2,0,0,2,1,1,0
2020,Kentucky,SEC,East,11,5,6,0,10,4,6,0,5,3,2,0,5,1,4,0
2020,Liberty,FBS Independents,,11,10,1,0,0,0,0,0,6,6,0,0,4,3,1,0
2020,Louisiana,Sun Belt,,11,10,1,0,8,7,1,0,4,3,1,0,6,6,0,0
2020,Louisiana Monroe,Sun Belt,,10,0,10,0,7,0,7,0,5,0,5,0,5,0,5,0
2020,Louisiana Tech,Conference USA,West,10,5,5,0,6,4,2,0,4,3,1,0,5,2,3,0
2020,Louisville,ACC,Atlantic,11,4,7,0,10,3,7,0,6,4,2,0,5,0,5,0
2020,LSU,SEC,West,10,5,5,0,10,5,5,0,5,2,3,0,5,3,2,0
2020,Marshall,Conference USA,East,10,7,3,0,6,4,2,0,7,5,2,0,2,2,0,0
2020,Maryland,Big Ten,East,5,2,3,0,5,2,3,0,2,1,1,0,3,1,2,0
2020,Memphis,American Athletic,West,11,8,3,0,8,5,3,0,6,6,0,0,4,1,3,0
2020,Miami,ACC,Coastal,11,8,3,0,9,7,2,0,5,4,1,0,5,4,1,0
2020,Miami (OH),Mid-American,East,3,2,1,0,3,2,1,0,1,1,0,0,2,1,1,0
2020,Michigan,Big Ten,East,6,2,4,0,6,2,4,0,3,0,3,0,3,2,1,0
2020,Michigan State,Big Ten,East,7,2,5,0,7,2,5,0,4,1,3,0,3,1,2,0
2020,Middle Tennessee,Conference USA,East,9,3,6,0,5,2,3,0,3,0,3,0,6,3,3,0
2020,Minnesota,Big Ten,West,7,3,4,0,7,3,4,0,3,1,2,0,4,2,2,0
2020,Mississippi State,SEC,West,11,4,7,0,10,3,7,0,5,2,3,0,5,1,4,0
2020,Missouri,SEC,East,10,5,5,0,10,5,5,0,5,3,2,0,5,2,3,0
2020,Navy,American Athletic,West,10,3,7,0,7,3,4,0,5,1,4,0,4,2,2,0
2020,NC State,ACC,Atlantic,12,8,4,0,10,7,3,0,6,5,1,0,5,3,2,0
2020,Nebraska,Big Ten,West,8,3,5,0,8,3,5,0,3,1,2,0,5,2,3,0
2020,Nevada,Mountain West,West,9,7,2,0,8,6,2,0,4,4,0,0,4,2,2,0
2020,New Mexico,Mountain West,Mountain,7,2,5,0,7,2,5,0,4,2,2,0,3,0,3,0
2020,North Carolina,ACC,Coastal,12,8,4,0,10,7,3,0,6,5,1,0,5,3,2,0
2020,Northern Illinois,Mid-American,West,6,0,6,0,6,0,6,0,3,0,3,0,3,0,3,0
2020,North Texas,Conference USA,West,10,4,6,0,7,3,4,0,6,2,4,0,3,2,1,0
2020,Northwestern,Big Ten,West,9,7,2,0,8,6,2,0,4,4,0,0,3,2,1,0
2020,Notre Dame,FBS Independents,,12,10,2,0,10,9,1,0,6,6,0,0,4,4,0,0
2020,Ohio,Mid-American,East,3,2,1,0,3,2,1,0,2,2,0,0,1,0,1,0
2020,Ohio State,Big Ten,East,8,7,1,0,6,6,0,0,3,3,0,0,2,2,0,0
2020,Oklahoma,Big 12,,11,9,2,0,9,7,2,0,5,4,1,0,3,2,1,0
2020,Oklahoma State,Big 12,,11,8,3,0,9,6,3,0,5,4,1,0,5,3,2,0
2020,Ole Miss,SEC,West,10,5,5,0,9,4,5,0,5,2,3,0,4,2,2,0
2020,Oregon,Pac-12,North,7,4,3,0,6,4,2,0,2,2,0,0,4,2,2,0
2020,Oregon State,Pac-12,North,7,2,5,0,7,2,5,0,5,2,3,0,2,0,2,0
2020,Penn State,Big Ten,East,9,4,5,0,9,4,5,0,5,2,3,0,4,2,2,0
2020,Pittsburgh,ACC,Coastal,11,6,5,0,10,5,5,0,6,4,2,0,5,2,3,0
2020,Purdue,Big Ten,West,6,2,4,0,6,2,4,0,4,1,3,0,2,1,1,0
2020,Rice,Conference USA,West,5,2,3,0,5,2,3,0,2,0,2,0,3,2,1,0
2020,Rutgers,Big Ten,East,9,3,6,0,9,3,6,0,5,0,5,0,4,3,1,0
2020,San Diego State,Mountain West,West,8,4,4,0,6,4,2,0,4,3,1,0,4,1,3,0
2020,San José State,Mountain West,West,8,7,1,0,7,7,0,0,4,4,0,0,2,2,0,0
2020,SMU,American Athletic,West,10,7,3,0,7,4,3,0,4,3,1,0,6,4,2,0
2020,South Alabama,Sun Belt,,11,4,7,0,8,3,5,0,6,2,4,0,5,2,3,0
2020,South Carolina,SEC,East,10,2,8,0,10,2,8,0,5,1,4,0,5,1,4,0
2020,Southern Mississippi,Conference USA,West,10,3,7,0,6,2,4,0,7,2,5,0,3,1,2,0
2020,South Florida,American Athletic,East,9,1,8,0,7,0,7,0,4,1,3,0,5,0,5,0
2020,Stanford,Pac-12,North,6,4,2,0,6,4,2,0,1,0,1,0,5,4,1,0
2020,Syracuse,ACC,Atlantic,11,1,10,0,10,1,9,0,6,1,5,0,5,0,5,0
2020,TCU,Big 12,,10,6,4,0,9,5,4,0,6,3,3,0,4,3,1,0
2020,Temple,American Athletic,East,7,1,6,0,7,1,6,0,3,1,2,0,4,0,4,0
2020,Tennessee,SEC,East,10,3,7,0,10,3,7,0,5,1,4,0,5,2,3,0
2020,Texas,Big 12,,10,7,3,0,8,5,3,0,5,3,2,0,3,3,0,0
2020,Texas A&M,SEC,West,10,9,1,0,9,8,1,0,4,4,0,0,5,4,1,0
2020,Texas State,Sun Belt,,12,2,10,0,8,2,6,0,6,1,5,0,6,1,5,0
2020,Texas Tech,Big 12,,10,4,6,0,9,3,6,0,6,4,2,0,4,0,4,0
2020,Toledo,Mid-American,West,6,4,2,0,6,4,2,0,3,2,1,0,3,2,1,0
2020,Troy,Sun Belt,,11,5,6,0,7,3,4,0,5,2,3,0,6,3,3,0
2020,Tulane,American Athletic,West,12,6,6,0,8,3,5,0,5,3,2,0,6,3,3,0
2020,Tulsa,American Athletic,West,9,6,3,0,7,6,1,0,3,3,0,0,5,3,2,0
2020,UAB,Conference USA,West,9,6,3,0,5,4,1,0,4,3,1,0,5,3,2,0
2020,UCF,American Athletic,East,10,6,4,0,8,5,3,0,4,2,2,0,5,4,1,0
2020,UCLA,Pac-12,South,7,3,4,0,7,3,4,0,4,2,2,0,3,1,2,0
2020,UMass,FBS Independents,,4,0,4,0,0,0,0,0,0,0,0,0,4,0,4,0
2020,UNLV,Mountain West,West,6,0,6,0,6,0,6,0,3,0,3,0,3,0,3,0
2020,USC,Pac-12,South,6,5,1,0,6,5,1,0,3,2,1,0,3,3,0,0
2020,Utah,Pac-12,South,5,3,2,0,5,3,2,0,3,2,1,0,2,1,1,0
2020,Utah State,Mountain West,Mountain,6,1,5,0,6,1,5,0,4,1,3,0,2,0,2,0
2020,UTEP,Conference USA,West,8,3,5,0,4,0,4,0,3,2,1,0,5,1,4,0
2020,UT San Antonio,Conference USA,West,12,7,5,0,6,4,2,0,6,5,1,0,5,2,3,0
2020,Vanderbilt,SEC,East,9,0,9,0,9,0,9,0,5,0,5,0,4,0,4,0
2020,Virginia,ACC,Coastal,10,5,5,0,9,4,5,0,6,5,1,0,4,0,4,0
2020,Virginia Tech,ACC,Coastal,11,5,6,0,10,5,5,0,6,3,3,0,5,2,3,0
2020,Wake Forest,ACC,Atlantic,9,4,5,0,7,3,4,0,4,3,1,0,4,1,3,0
2020,Washington,Pac-12,North,4,3,1,0,4,3,1,0,4,3,1,0,0,0,0,0
2020,Washington State,Pac-12,North,4,1,3,0,4,1,3,0,1,0,1,0,3,1,2,0
2020,Western Kentucky,Conference USA,East,12,5,7,0,7,4,3,0,5,3,2,0,6,2,4,0
2020,Western Michigan,Mid-American,West,6,4,2,0,6,4,2,0,3,2,1,0,3,2,1,0
2020,West Virginia,Big 12,,10,6,4,0,8,4,4,0,5,5,0,0,4,0,4,0
2020,Wisconsin,Big Ten,West,7,4,3,0,6,3,3,0,3,2,1,0,3,1,2,0
2020,Wyoming,Mountain West,Mountain,6,2,4,0,6,2,4,0,2,1,1,0,4,1,3,0
2019,Air Force,Mountain West,Mountain,13,11,2,0,8,7,1,0,6,6,0,0,6,4,2,0
2019,Akron,Mid-American,East,12,0,12,0,8,0,8,0,6,0,6,0,6,0,6,0
2019,Alabama,SEC,West,13,11,2,0,8,6,2,0,7,6,1,0,4,3,1,0
2019,Appalachian State,Sun Belt,,14,13,1,0,9,8,1,0,7,6,1,0,6,6,0,0
2019,Arizona,Pac-12,South,12,4,8,0,9,2,7,0,6,3,3,0,6,1,5,0
2019,Arizona State,Pac-12,South,13,8,5,0,9,4,5,0,7,5,2,0,5,2,3,0
2019,Arkansas,SEC,West,12,2,10,0,8,0,8,0,7,2,5,0,4,0,4,0
2019,Arkansas State,Sun Belt,,13,8,5,0,8,5,3,0,6,4,2,0,6,3,3,0
2019,Army,FBS Independents,,13,5,8,0,0,0,0,0,6,4,2,0,6,1,5,0
2019,Auburn,SEC,West,13,9,4,0,8,5,3,0,7,6,1,0,4,2,2,0
2019,Ball State,Mid-American,West,12,5,7,0,8,4,4,0,6,3,3,0,5,2,3,0
2019,Baylor,Big 12,,14,11,3,0,10,8,2,0,7,6,1,0,5,5,0,0
2019,Boise State,Mountain West,Mountain,14,12,2,0,9,9,0,0,7,7,0,0,6,5,1,0
2019,Boston College,ACC,Atlantic,13,6,7,0,8,4,4,0,6,3,3,0,6,3,3,0
2019,Bowling Green,Mid-American,East,12,3,9,0,8,2,6,0,6,3,3,0,6,0,6,0
2019,Buffalo,Mid-American,East,13,8,5,0,8,5,3,0,6,5,1,0,6,2,4,0
2019,BYU,FBS Independents,,13,7,6,0,0,0,0,0,6,4,2,0,6,3,3,0
2019,California,Pac-12,North,13,8,5,0,9,4,5,0,6,3,3,0,6,4,2,0
2019,Central Michigan,Mid-American,West,14,8,6,0,9,6,3,0,6,6,0,0,6,2,4,0
2019,Charlotte,Conference USA,East,13,7,6,0,8,5,3,0,6,5,1,0,6,2,4,0
2019,Cincinnati,American Athletic,East,14,11,3,0,9,7,2,0,6,6,0,0,7,4,3,0
2019,Clemson,ACC,Atlantic,15,14,1,0,9,9,0,0,7,7,0,0,5,5,0,0
2019,Coastal Carolina,Sun Belt,,12,5,7,0,8,2,6,0,6,3,3,0,6,2,4,0
2019,Colorado,Pac-12,South,12,5,7,0,9,3,6,0,6,3,3,0,5,1,4,0
2019,Colorado State,Mountain West,Mountain,12,4,8,0,8,3,5,0,6,2,4,0,5,2,3,0
2019,Connecticut,American Athletic,East,12,2,10,0,8,0,8,0,6,1,5,0,6,1,5,0
2019,Duke,ACC,Coastal,12,5,7,0,8,3,5,0,6,3,3,0,5,2,3,0
2019,East Carolina,American Athletic,East,12,4,8,0,8,1,7,0,6,2,4,0,6,2,4,0
2019,Eastern Michigan,Mid-American,West,13,6,7,0,8,3,5,0,5,2,3,0,7,4,3,0
2019,Florida,SEC,East,13,11,2,0,8,6,2,0,6,6,0,0,4,3,1,0
2019,Florida Atlantic,Conference USA,East,14,11,3,0,9,8,1,0,8,6,2,0,6,5,1,0
2019,Florida International,Conference USA,East,13,6,7,0,8,3,5,0,7,6,1,0,5,0,5,0
2019,Florida State,ACC,Atlantic,13,6,7,0,8,4,4,0,7,5,2,0,5,1,4,0
2019,Fresno State,Mountain West,West,12,4,8,0,8,2,6,0,6,2,4,0,6,2,4,0
2019,Georgia,SEC,East,14,12,2,0,9,7,2,0,7,6,1,0,4,4,0,0
2019,Georgia Southern,Sun Belt,,13,7,6,0,8,5,3,0,6,5,1,0,6,2,4,0
2019,Georgia State,Sun Belt,,13,7,6,0,8,4,4,0,6,5,1,0,6,2,4,0
2019,Georgia Tech,ACC,Coastal,12,3,9,0,8,2,6,0,7,2,5,0,5,1,4,0
2019,Hawai'i,Mountain West,West,15,10,5,0,9,5,4,0,8,6,2,0,6,3,3,0
2019,Houston,American Athletic,West,12,4,8,0,8,2,6,0,5,1,4,0,6,3,3,0
2019,Illinois,Big Ten,West,13,6,7,0,9,4,5,0,7,3,4,0,5,3,2,0
2019,Indiana,Big Ten,East,13,8,5,0,9,5,4,0,6,4,2,0,5,3,2,0
2019,Iowa,Big Ten,West,13,10,3,0,9,6,3,0,7,6,1,0,5,3,2,0
2019,Iowa State,Big 12,,13,7,6,0,9,5,4,0,7,5,2,0,5,2,3,0
2019,Kansas,Big 12,,12,3,9,0,9,1,8,0,7,2,5,0,5,1,4,0
2019,Kansas State,Big 12,,13,8,5,0,9,5,4,0,7,5,2,0,5,3,2,0
2019,Kent State,Mid-American,East,13,7,6,0,8,5,3,0,5,4,1,0,7,2,5,0
2019,Kentucky,SEC,East,13,8,5,0,8,3,5,0,8,6,2,0,4,1,3,0
2019,Liberty,FBS Independents,,13,8,5,0,0,0,0,0,6,5,1,0,6,2,4,0
2019,Louisiana,Sun Belt,,14,11,3,0,9,7,2,0,6,5,1,0,6,5,1,0
2019,Louisiana Monroe,Sun Belt,,12,5,7,0,8,4,4,0,6,4,2,0,6,1,5,0
2019,Louisiana Tech,Conference USA,West,13,10,3,0,8,6,2,0,6,6,0,0,6,3,3,0
2019,Louisville,ACC,Atlantic,13,8,5,0,8,5,3,0,6,4,2,0,5,2,3,0
2019,LSU,SEC,West,15,15,0,0,9,9,0,0,7,7,0,0,5,5,0,0
2019,Marshall,Conference USA,East,13,8,5,0,8,6,2,0,7,6,1,0,5,2,3,0
2019,Maryland,Big Ten,East,12,3,9,0,9,1,8,0,6,2,4,0,6,1,5,0
2019,Memphis,American Athletic,West,14,12,2,0,9,8,1,0,7,7,0,0,6,5,1,0
2019,Miami,ACC,Coastal,13,6,7,0,8,4,4,0,6,4,2,0,5,2,3,0
2019,Miami (OH),Mid-American,East,14,8,6,0,9,7,2,0,5,5,0,0,7,2,5,0
2019,Michigan,Big Ten,East,13,9,4,0,9,6,3,0,7,6,1,0,5,3,2,0
2019,Michigan State,Big Ten,East,13,7,6,0,9,4,5,0,7,4,3,0,5,2,3,0
2019,Middle Tennessee,Conference USA,East,12,4,8,0,8,3,5,0,6,4,2,0,6,0,6,0
2019,Minnesota,Big Ten,West,13,11,2,0,9,7,2,0,7,6,1,0,5,4,1,0
2019,Mississippi State,SEC,West,13,6,7,0,8,3,5,0,7,4,3,0,4,1,3,0
2019,Missouri,SEC,East,12,6,6,0,8,3,5,0,7,5,2,0,5,1,4,0
2019,Navy,American Athletic,West,13,11,2,0,8,7,1,0,6,6,0,0,5,3,2,0
2019,NC State,ACC,Atlantic,12,4,8,0,8,1,7,0,7,4,3,0,5,0,5,0
2019,Nebraska,Big Ten,West,12,5,7,0,9,3,6,0,7,3,4,0,5,2,3,0
2019,Nevada,Mountain West,West,13,7,6,0,8,4,4,0,6,4,2,0,6,3,3,0
2019,New Mexico,Mountain West,Mountain,12,2,10,0,8,0,8,0,6,2,4,0,6,0,6,0
2019,New Mexico State,FBS Independents,,12,2,10,0,0,0,0,0,5,2,3,0,7,0,7,0
2019,North Carolina,ACC,Coastal,13,7,6,0,8,4,4,0,6,3,3,0,5,2,3,0
2019,Northern Illinois,Mid-American,West,12,5,7,0,8,4,4,0,5,3,2,0,7,2,5,0
2019,North Texas,Conference USA,West,12,4,8,0,8,3,5,0,6,4,2,0,6,0,6,0
2019,Northwestern,Big Ten,West,12,3,9,0,9,1,8,0,7,2,5,0,5,1,4,0
2019,Notre Dame,FBS Independents,,13,11,2,0,0,0,0,0,7,7,0,0,5,3,2,0
2019,Ohio,Mid-American,East,13,7,6,0,8,5,3,0,6,2,4,0,6,4,2,0
2019,Ohio State,Big Ten,East,14,13,1,0,10,10,0,0,7,7,0,0,5,5,0,0
2019,Oklahoma,Big 12,,14,12,2,0,10,9,1,0,6,6,0,0,5,4,1,0
2019,Oklahoma State,Big 12,,13,8,5,0,9,5,4,0,6,4,2,0,6,4,2,0
2019,Old Dominion,Conference USA,East,12,1,11,0,8,0,8,0,6,1,5,0,6,0,6,0
2019,Ole Miss,SEC,West,12,4,8,0,8,2,6,0,7,4,3,0,5,0,5,0
2019,Oregon,Pac-12,North,14,12,2,0,10,9,1,0,7,7,0,0,4,3,1,0
2019,Oregon State,Pac-12,North,12,5,7,0,9,4,5,0,6,2,4,0,6,3,3,0
2019,Penn State,Big Ten,East,13,11,2,0,9,7,2,0,7,7,0,0,5,3,2,0
2019,Pittsburgh,ACC,Coastal,13,8,5,0,8,4,4,0,7,4,3,0,5,3,2,0
2019,Purdue,Big Ten,West,12,4,8,0,9,3,6,0,7,3,4,0,5,1,4,0
2019,Rice,Conference USA,West,12,3,9,0,8,3,5,0,6,1,5,0,5,2,3,0
2019,Rutgers,Big Ten,East,12,2,10,0,9,0,9,0,7,2,5,0,5,0,5,0
2019,San Diego State,Mountain West,West,13,10,3,0,8,5,3,0,6,4,2,0,6,5,1,0
2019,San José State,Mountain West,West,12,5,7,0,8,2,6,0,6,3,3,0,6,2,4,0
2019,SMU,American Athletic,West,13,10,3,0,8,6,2,0,6,6,0,0,7,4,3,0
2019,South Alabama,Sun Belt,,12,2,10,0,8,1,7,0,6,2,4,0,6,0,6,0
2019,South Carolina,SEC,East,12,4,8,0,8,3,5,0,7,3,4,0,4,1,3,0
2019,Southern Mississippi,Conference USA,West,13,7,6,0,8,5,3,0,5,4,1,0,7,3,4,0
2019,South Florida,American Athletic,East,12,4,8,0,8,2,6,0,7,2,5,0,5,2,3,0
2019,Stanford,Pac-12,North,12,4,8,0,9,3,6,0,7,3,4,0,5,1,4,0
2019,Syracuse,ACC,Atlantic,12,5,7,0,8,2,6,0,6,3,3,0,6,2,4,0
2019,TCU,Big 12,,12,5,7,0,9,3,6,0,6,3,3,0,6,2,4,0
2019,Temple,American Athletic,East,13,8,5,0,8,5,3,0,7,6,1,0,5,2,3,0
2019,Tennessee,SEC,East,13,8,5,0,8,5,3,0,8,5,3,0,4,2,2,0
2019,Texas,Big 12,,13,8,5,0,9,5,4,0,6,5,1,0,4,1,3,0
2019,Texas A&M,SEC,West,13,8,5,0,8,4,4,0,7,5,2,0,4,1,3,0
2019,Texas State,Sun Belt,,12,3,9,0,8,2,6,0,6,3,3,0,6,0,6,0
2019,Texas Tech,Big 12,,12,4,8,0,9,2,7,0,6,3,3,0,6,1,5,0
2019,Toledo,Mid-American,West,12,6,6,0,8,3,5,0,6,5,1,0,6,1,5,0
2019,Troy,Sun Belt,,12,5,7,0,8,3,5,0,6,3,3,0,6,2,4,0
2019,Tulane,American Athletic,West,13,7,6,0,8,3,5,0,6,5,1,0,6,1,5,0
2019,Tulsa,American Athletic,West,12,4,8,0,8,2,6,0,6,2,4,0,6,2,4,0
2019,UAB,Conference USA,West,14,9,5,0,9,6,3,0,6,6,0,0,7,3,4,0
2019,UCF,American Athletic,East,13,10,3,0,8,6,2,0,6,6,0,0,6,3,3,0
2019,UCLA,Pac-12,South,12,4,8,0,9,4,5,0,6,2,4,0,6,2,4,0
2019,UMass,FBS Independents,,12,1,11,0,0,0,0,0,6,1,5,0,6,0,6,0
2019,UNLV,Mountain West,West,12,4,8,0,8,2,6,0,6,2,4,0,6,2,4,0
2019,USC,Pac-12,South,13,8,5,0,9,7,2,0,6,5,1,0,6,3,3,0
2019,Utah,Pac-12,South,14,11,3,0,10,8,2,0,7,7,0,0,5,4,1,0
2019,Utah State,Mountain West,Mountain,13,7,6,0,8,6,2,0,6,4,2,0,6,3,3,0
2019,UTEP,Conference USA,West,12,1,11,0,8,0,8,0,6,1,5,0,6,0,6,0
2019,UT San Antonio,Conference USA,West,12,4,8,0,8,3,5,0,6,2,4,0,6,2,4,0
2019,Vanderbilt,SEC,East,12,3,9,0,8,1,7,0,7,3,4,0,5,0,5,0
2019,Virginia,ACC,Coastal,14,9,5,0,9,6,3,0,7,7,0,0,5,2,3,0
2019,Virginia Tech,ACC,Coastal,13,8,5,0,8,5,3,0,7,6,1,0,5,2,3,0
2019,Wake Forest,ACC,Atlantic,13,8,5,0,8,4,4,0,7,6,1,0,5,2,3,0
2019,Washington,Pac-12,North,13,8,5,0,9,4,5,0,7,4,3,0,5,3,2,0
2019,Washington State,Pac-12,North,13,6,7,0,9,3,6,0,6,5,1,0,5,0,5,0
2019,Western Kentucky,Conference USA,East,13,9,4,0,8,6,2,0,6,4,2,0,5,4,1,0
2019,Western Michigan,Mid-American,West,13,7,6,0,8,5,3,0,6,6,0,0,6,1,5,0
2019,West Virginia,Big 12,,12,5,7,0,9,3,6,0,6,2,4,0,6,3,3,0
2019,Wisconsin,Big Ten,West,14,10,4,0,10,7,3,0,7,7,0,0,5,3,2,0
2019,Wyoming,Mountain West,Mountain,13,8,5,0,8,4,4,0,6,6,0,0,6,1,5,0
2018,Air Force,Mountain West,Mountain,12,5,7,0,8,3,5,0,6,4,2,0,6,1,5,0
2018,Akron,Mid-American,East,12,4,8,0,8,2,6,0,5,2,3,0,7,2,5,0
2018,Alabama,SEC,West,15,14,1,0,9,9,0,0,7,7,0,0,4,4,0,0
2018,Appalachian State,Sun Belt,,13,11,2,0,9,8,1,0,6,6,0,0,6,4,2,0
2018,Arizona,Pac-12,South,12,5,7,0,9,4,5,0,7,4,3,0,5,1,4,0
2018,Arizona State,Pac-12,South,13,7,6,0,9,5,4,0,6,5,1,0,6,2,4,0
2018,Arkansas,SEC,West,12,2,10,0,8,0,8,0,7,2,5,0,4,0,4,0
2018,Arkansas State,Sun Belt,,13,8,5,0,8,5,3,0,6,5,1,0,6,3,3,0
2018,Army,FBS Independents,,13,11,2,0,0,0,0,0,6,6,0,0,4,2,2,0
2018,Auburn,SEC,West,13,8,5,0,8,3,5,0,7,5,2,0,4,1,3,0
2018,Ball State,Mid-American,West,12,4,8,0,8,3,5,0,6,3,3,0,6,1,5,0
2018,Baylor,Big 12,,13,7,6,0,9,4,5,0,6,4,2,0,5,1,4,0
2018,Boise State,Mountain West,Mountain,13,10,3,0,9,7,2,0,7,5,2,0,6,5,1,0
2018,Boston College,ACC,Atlantic,12,7,5,0,8,4,4,0,7,5,2,0,5,2,3,0
2018,Bowling Green,Mid-American,East,12,3,9,0,8,2,6,0,6,1,5,0,6,2,4,0
2018,Buffalo,Mid-American,East,14,10,4,0,9,7,2,0,6,5,1,0,6,5,1,0
2018,BYU,FBS Independents,,13,7,6,0,0,0,0,0,6,3,3,0,6,3,3,0
2018,California,Pac-12,North,13,7,6,0,9,4,5,0,7,4,3,0,5,3,2,0
2018,Central Michigan,Mid-American,West,12,1,11,0,8,0,8,0,6,1,5,0,6,0,6,0
2018,Charlotte,Conference USA,East,12,5,7,0,8,4,4,0,6,4,2,0,6,1,5,0
2018,Cincinnati,American Athletic,East,13,11,2,0,8,6,2,0,6,6,0,0,6,4,2,0
2018,Clemson,ACC,Atlantic,15,15,0,0,9,9,0,0,7,7,0,0,5,5,0,0
2018,Coastal Carolina,Sun Belt,,12,5,7,0,8,2,6,0,5,1,4,0,7,4,3,0
2018,Colorado,Pac-12,South,12,5,7,0,9,2,7,0,6,3,3,0,5,1,4,0
2018,Colorado State,Mountain West,Mountain,12,3,9,0,8,2,6,0,6,2,4,0,5,1,4,0
2018,Connecticut,American Athletic,East,12,1,11,0,8,0,8,0,6,1,5,0,6,0,6,0
2018,Duke,ACC,Coastal,13,8,5,0,8,3,5,0,6,3,3,0,6,4,2,0
2018,East Carolina,American Athletic,East,12,3,9,0,8,1,7,0,7,3,4,0,5,0,5,0
2018,Eastern Michigan,Mid-American,West,13,7,6,0,8,5,3,0,6,4,2,0,6,3,3,0
2018,Florida,SEC,East,13,10,3,0,8,5,3,0,7,5,2,0,4,4,0,0
2018,Florida Atlantic,Conference USA,East,12,5,7,0,8,3,5,0,6,4,2,0,6,1,5,0
2018,Florida International,Conference USA,East,13,9,4,0,8,6,2,0,7,4,3,0,5,4,1,0
2018,Florida State,ACC,Atlantic,12,5,7,0,8,3,5,0,7,4,3,0,5,1,4,0
2018,Fresno State,Mountain West,West,14,12,2,0,9,8,1,0,6,6,0,0,7,5,2,0
2018,Georgia,SEC,East,14,11,3,0,9,7,2,0,7,7,0,0,4,3,1,0
2018,Georgia Southern,Sun Belt,,13,10,3,0,8,6,2,0,6,5,1,0,6,4,2,0
2018,Georgia State,Sun Belt,,12,2,10,0,8,1,7,0,6,2,4,0,6,0,6,0
2018,Georgia Tech,ACC,Coastal,13,7,6,0,8,5,3,0,6,4,2,0,6,3,3,0
2018,Hawai'i,Mountain West,West,14,8,6,0,8,5,3,0,7,5,2,0,6,3,3,0
2018,Houston,American Athletic,West,13,8,5,0,8,5,3,0,6,5,1,0,6,3,3,0
2018,Illinois,Big Ten,West,12,4,8,0,9,2,7,0,6,3,3,0,5,1,4,0
2018,Indiana,Big Ten,East,12,5,7,0,9,2,7,0,7,3,4,0,5,2,3,0
2018,Iowa,Big Ten,West,13,9,4,0,9,5,4,0,7,5,2,0,5,3,2,0
2018,Iowa State,Big 12,,13,8,5,0,9,6,3,0,7,6,1,0,5,2,3,0
2018,Kansas,Big 12,,12,3,9,0,9,1,8,0,6,2,4,0,6,1,5,0
2018,Kansas State,Big 12,,12,5,7,0,9,3,6,0,7,5,2,0,5,0,5,0
2018,Kent State,Mid-American,East,12,2,10,0,8,1,7,0,5,1,4,0,7,1,6,0
2018,Kentucky,SEC,East,13,9,4,0,8,4,4,0,7,6,1,0,5,2,3,0
2018,Liberty,FBS Independents,,12,6,6,0,0,0,0,0,6,5,1,0,6,1,5,0
2018,Louisiana,Sun Belt,,14,7,7,0,9,5,4,0,6,5,1,0,7,2,5,0
2018,Louisiana Monroe,Sun Belt,,12,6,6,0,8,4,4,0,5,3,2,0,7,3,4,0
2018,Louisiana Tech,Conference USA,West,13,8,5,0,8,5,3,0,5,3,2,0,7,4,3,0
2018,Louisville,ACC,Atlantic,12,2,10,0,8,0,8,0,7,2,5,0,4,0,4,0
2018,LSU,SEC,West,13,10,3,0,8,5,3,0,7,6,1,0,4,2,2,0
2018,Marshall,Conference USA,East,13,9,4,0,8,6,2,0,6,4,2,0,7,5,2,0
2018,Maryland,Big Ten,East,12,5,7,0,9,3,6,0,6,3,3,0,5,1,4,0
2018,Memphis,American Athletic,West,14,8,6,0,9,5,4,0,7,6,1,0,6,2,4,0
2018,Miami,ACC,Coastal,13,7,6,0,8,4,4,0,6,5,1,0,5,2,3,0
2018,Miami (OH),Mid-American,East,12,6,6,0,8,6,2,0,6,3,3,0,6,3,3,0
2018,Michigan,Big Ten,East,13,10,3,0,9,8,1,0,7,7,0,0,5,3,2,0
2018,Michigan State,Big Ten,East,13,7,6,0,9,5,4,0,7,4,3,0,5,3,2,0
2018,Middle Tennessee,Conference USA,East,14,8,6,0,9,7,2,0,6,5,1,0,7,3,4,0
2018,Minnesota,Big Ten,West,13,7,6,0,9,3,6,0,7,5,2,0,5,1,4,0
2018,Mississippi State,SEC,West,13,8,5,0,8,4,4,0,7,6,1,0,5,2,3,0
2018,Missouri,SEC,East,13,9,4,0,8,5,3,0,7,6,1,0,5,3,2,0
2018,Navy,American Athletic,West,13,3,10,0,8,2,6,0,5,3,2,0,6,0,6,0
2018,NC State,ACC,Atlantic,13,9,4,0,8,5,3,0,7,6,1,0,5,3,2,0
2018,Nebraska,Big Ten,West,12,4,8,0,9,3,6,0,7,4,3,0,5,0,5,0
2018,Nevada,Mountain West,West,13,8,5,0,8,5,3,0,6,4,2,0,6,3,3,0
2018,New Mexico,Mountain West,Mountain,12,3,9,0,8,1,7,0,6,1,5,0,6,2,4,0
2018,New Mexico State,FBS Independents,,12,3,9,0,0,0,0,0,5,2,3,0,7,1,6,0
2018,North Carolina,ACC,Coastal,11,2,9,0,8,1,7,0,5,2,3,0,6,0,6,0
2018,Northern Illinois,Mid-American,West,14,8,6,0,9,7,2,0,5,3,2,0,7,4,3,0
2018,North Texas,Conference USA,West,13,9,4,0,8,5,3,0,6,5,1,0,6,4,2,0
2018,Northwestern,Big Ten,West,14,9,5,0,10,8,2,0,7,3,4,0,5,5,0,0
2018,Notre Dame,FBS Independents,,13,12,1,0,0,0,0,0,6,6,0,0,4,4,0,0
2018,Ohio,Mid-American,East,13,9,4,0,8,6,2,0,6,6,0,0,6,2,4,0
2018,Ohio State,Big Ten,East,14,13,1,0,10,9,1,0,7,7,0,0,4,3,1,0
2018,Oklahoma,Big 12,,14,12,2,0,10,9,1,0,7,7,0,0,4,4,0,0
2018,Oklahoma State,Big 12,,13,7,6,0,9,3,6,0,7,5,2,0,5,1,4,0
2018,Old Dominion,Conference USA,East,12,4,8,0,8,2,6,0,6,3,3,0,6,1,5,0
2018,Ole Miss,SEC,West,12,5,7,0,8,1,7,0,7,3,4,0,4,1,3,0
2018,Oregon,Pac-12,North,13,9,4,0,9,5,4,0,7,6,1,0,5,2,3,0
2018,Oregon State,Pac-12,North,12,2,10,0,9,1,8,0,6,1,5,0,6,1,5,0
2018,Penn State,Big Ten,East,13,9,4,0,9,6,3,0,7,5,2,0,5,4,1,0
2018,Pittsburgh,ACC,Coastal,14,7,7,0,9,6,3,0,6,5,1,0,6,2,4,0
2018,Purdue,Big Ten,West,13,6,7,0,9,5,4,0,7,3,4,0,5,3,2,0
2018,Rice,Conference USA,West,13,2,11,0,8,1,7,0,6,2,4,0,7,0,7,0
2018,Rutgers,Big Ten,East,12,1,11,0,9,0,9,0,7,1,6,0,5,0,5,0
2018,San Diego State,Mountain West,West,13,7,6,0,8,4,4,0,7,5,2,0,5,2,3,0
2018,San José State,Mountain West,West,12,1,11,0,8,1,7,0,5,1,4,0,6,0,6,0
2018,SMU,American Athletic,West,12,5,7,0,8,4,4,0,6,3,3,0,6,2,4,0
2018,South Alabama,Sun Belt,,12,3,9,0,8,2,6,0,6,3,3,0,6,0,6,0
2018,South Carolina,SEC,East,13,7,6,0,8,4,4,0,7,5,2,0,5,2,3,0
2018,Southern Mississippi,Conference USA,West,11,6,5,0,8,5,3,0,6,5,1,0,5,1,4,0
2018,South Florida,American Athletic,East,13,7,6,0,8,3,5,0,7,4,3,0,5,2,3,0
2018,Stanford,Pac-12,North,13,9,4,0,9,6,3,0,6,4,2,0,6,4,2,0
2018,Syracuse,ACC,Atlantic,13,10,3,0,8,6,2,0,6,6,0,0,5,3,2,0
2018,TCU,Big 12,,13,7,6,0,9,4,5,0,6,4,2,0,5,2,3,0
2018,Temple,American Athletic,East,13,8,5,0,8,7,1,0,6,4,2,0,6,4,2,0
2018,Tennessee,SEC,East,12,5,7,0,8,2,6,0,7,4,3,0,4,1,3,0
2018,Texas,Big 12,,14,10,4,0,10,7,3,0,6,5,1,0,4,3,1,0
2018,Texas A&M,SEC,West,13,9,4,0,8,5,3,0,7,6,1,0,4,1,3,0
2018,Texas State,Sun Belt,,12,3,9,0,8,1,7,0,6,2,4,0,6,1,5,0
2018,Texas Tech,Big 12,,12,5,7,0,9,3,6,0,6,3,3,0,4,2,2,0
2018,Toledo,Mid-American,West,13,7,6,0,8,5,3,0,7,5,2,0,5,2,3,0
2018,Troy,Sun Belt,,13,10,3,0,8,7,1,0,6,5,1,0,6,4,2,0
2018,Tulane,American Athletic,West,13,7,6,0,8,5,3,0,6,4,2,0,6,2,4,0
2018,Tulsa,American Athletic,West,12,3,9,0,8,2,6,0,6,3,3,0,6,0,6,0
2018,UAB,Conference USA,West,14,11,3,0,9,8,1,0,6,6,0,0,7,4,3,0
2018,UCF,American Athletic,East,13,12,1,0,9,9,0,0,8,8,0,0,4,4,0,0
2018,UCLA,Pac-12,South,12,3,9,0,9,3,6,0,7,2,5,0,5,1,4,0
2018,UMass,FBS Independents,,12,4,8,0,0,0,0,0,6,3,3,0,6,1,5,0
2018,UNLV,Mountain West,West,12,4,8,0,8,2,6,0,6,3,3,0,6,1,5,0
2018,USC,Pac-12,South,12,5,7,0,9,4,5,0,6,3,3,0,6,2,4,0
2018,Utah,Pac-12,South,14,9,5,0,10,6,4,0,6,5,1,0,6,4,2,0
2018,Utah State,Mountain West,Mountain,13,11,2,0,8,7,1,0,6,6,0,0,6,4,2,0
2018,UTEP,Conference USA,West,12,1,11,0,8,1,7,0,6,0,6,0,6,1,5,0
2018,UT San Antonio,Conference USA,West,12,3,9,0,8,2,6,0,6,2,4,0,6,1,5,0
2018,Vanderbilt,SEC,East,13,6,7,0,8,3,5,0,7,5,2,0,5,1,4,0
2018,Virginia,ACC,Coastal,13,8,5,0,8,4,4,0,7,6,1,0,5,1,4,0
2018,Virginia Tech,ACC,Coastal,13,6,7,0,8,4,4,0,7,3,4,0,5,3,2,0
2018,Wake Forest,ACC,Atlantic,13,7,6,0,8,3,5,0,7,2,5,0,5,4,1,0
2018,Washington,Pac-12,North,14,10,4,0,10,8,2,0,6,6,0,0,5,3,2,0
2018,Washington State,Pac-12,North,13,11,2,0,9,7,2,0,7,6,1,0,5,4,1,0
2018,Western Kentucky,Conference USA,East,12,3,9,0,8,2,6,0,5,1,4,0,7,2,5,0
2018,Western Michigan,Mid-American,West,13,7,6,0,8,5,3,0,6,3,3,0,6,4,2,0
2018,West Virginia,Big 12,,12,8,4,0,9,6,3,0,6,5,1,0,4,2,2,0
2018,Wisconsin,Big Ten,West,13,8,5,0,9,5,4,0,7,5,2,0,5,2,3,0
2018,Wyoming,Mountain West,Mountain,12,6,6,0,8,4,4,0,6,3,3,0,6,3,3,0
2017,Air Force,Mountain West,Mountain,12,5,7,0,8,4,4,0,6,3,3,0,6,2,4,0
2017,Akron,Mid-American,East,14,7,7,0,9,6,3,0,6,5,1,0,7,2,5,0
2017,Alabama,SEC,West,14,13,1,0,9,8,1,0,7,7,0,0,4,3,1,0
2017,Appalachian State,Sun Belt,,13,9,4,0,8,7,1,0,6,5,1,0,6,3,3,0
2017,Arizona,Pac-12,South,13,7,6,0,9,5,4,0,6,4,2,0,6,3,3,0
2017,Arizona State,Pac-12,South,13,7,6,0,9,6,3,0,7,5,2,0,5,2,3,0
2017,Arkansas,SEC,West,12,4,8,0,8,1,7,0,6,2,4,0,4,1,3,0
2017,Arkansas State,Sun Belt,,12,7,5,0,8,6,2,0,5,4,1,0,6,3,3,0
2017,Army,FBS Independents,,13,10,3,0,0,0,0,0,6,6,0,0,5,2,3,0
2017,Auburn,SEC,West,14,10,4,0,9,7,2,0,7,7,0,0,5,3,2,0
2017,Ball State,Mid-American,West,12,2,10,0,8,0,8,0,6,2,4,0,6,0,6,0
2017,Baylor,Big 12,,12,1,11,0,9,1,8,0,6,0,6,0,5,1,4,0
2017,Boise State,Mountain West,Mountain,14,11,3,0,9,8,1,0,7,6,1,0,6,4,2,0
2017,Boston College,ACC,Atlantic,13,7,6,0,8,4,4,0,6,2,4,0,5,4,1,0
2017,Bowling Green,Mid-American,East,12,2,10,0,8,2,6,0,5,0,5,0,7,2,5,0
2017,Buffalo,Mid-American,East,12,6,6,0,8,4,4,0,6,4,2,0,6,2,4,0
2017,BYU,FBS Independents,,13,4,9,0,0,0,0,0,6,2,4,0,6,2,4,0
2017,California,Pac-12,North,12,5,7,0,9,2,7,0,6,4,2,0,6,1,5,0
2017,Central Michigan,Mid-American,West,13,8,5,0,8,6,2,0,5,3,2,0,7,5,2,0
2017,Charlotte,Conference USA,East,12,1,11,0,8,1,7,0,6,1,5,0,6,0,6,0
2017,Cincinnati,American Athletic,East,12,4,8,0,8,2,6,0,6,2,4,0,6,2,4,0
2017,Clemson,ACC,Atlantic,14,12,2,0,9,8,1,0,7,7,0,0,5,4,1,0
2017,Coastal Carolina,Sun Belt,,12,3,9,0,8,2,6,0,6,2,4,0,6,1,5,0
2017,Colorado,Pac-12,South,12,5,7,0,9,2,7,0,6,3,3,0,5,1,4,0
2017,Colorado State,Mountain West,Mountain,13,7,6,0,8,5,3,0,6,4,2,0,5,3,2,0
2017,Connecticut,American Athletic,East,12,3,9,0,8,2,6,0,6,2,4,0,5,1,4,0
2017,Duke,ACC,Coastal,13,7,6,0,8,3,5,0,7,4,3,0,5,2,3,0
2017,East Carolina,American Athletic,East,12,3,9,0,8,2,6,0,7,2,5,0,5,1,4,0
2017,Eastern Michigan,Mid-American,West,12,5,7,0,8,3,5,0,5,3,2,0,7,2,5,0
2017,Florida,SEC,East,11,4,7,0,8,3,5,0,6,3,3,0,3,1,2,0
2017,Florida Atlantic,Conference USA,East,14,11,3,0,9,9,0,0,8,7,1,0,6,4,2,0
2017,Florida International,Conference USA,East,13,8,5,0,8,5,3,0,6,5,1,0,5,2,3,0
2017,Florida State,ACC,Atlantic,13,7,6,0,8,3,5,0,6,3,3,0,5,3,2,0
2017,Fresno State,Mountain West,West,14,10,4,0,9,7,2,0,6,5,1,0,7,4,3,0
2017,Georgia,SEC,East,15,13,2,0,10,8,2,0,6,6,0,0,5,4,1,0
2017,Georgia Southern,Sun Belt,,12,2,10,0,8,2,6,0,4,1,3,0,7,1,6,0
2017,Georgia State,Sun Belt,,12,7,5,0,8,5,3,0,5,1,4,0,6,5,1,0
2017,Georgia Tech,ACC,Coastal,11,5,6,0,8,4,4,0,6,5,1,0,4,0,4,0
2017,Hawai'i,Mountain West,West,12,3,9,0,8,1,7,0,6,2,4,0,6,1,5,0
2017,Houston,American Athletic,West,12,7,5,0,8,5,3,0,6,4,2,0,5,3,2,0
2017,Idaho,Sun Belt,,12,4,8,0,8,3,5,0,6,2,4,0,6,2,4,0
2017,Illinois,Big Ten,West,12,2,10,0,9,0,9,0,7,2,5,0,5,0,5,0
2017,Indiana,Big Ten,East,12,5,7,0,9,2,7,0,6,3,3,0,6,2,4,0
2017,Iowa,Big Ten,West,13,8,5,0,9,4,5,0,7,5,2,0,5,2,3,0
2017,Iowa State,Big 12,,13,8,5,0,9,5,4,0,6,3,3,0,7,5,2,0
2017,Kansas,Big 12,,12,1,11,0,9,0,9,0,7,1,6,0,5,0,5,0
2017,Kansas State,Big 12,,13,8,5,0,9,5,4,0,7,4,3,0,5,3,2,0
2017,Kent State,Mid-American,East,12,2,10,0,8,1,7,0,5,2,3,0,7,0,7,0
2017,Kentucky,SEC,East,13,7,6,0,8,4,4,0,7,4,3,0,5,3,2,0
2017,Louisiana,Sun Belt,,12,5,7,0,8,4,4,0,5,3,2,0,7,2,5,0
2017,Louisiana Monroe,Sun Belt,,12,4,8,0,8,4,4,0,5,2,3,0,7,2,5,0
2017,Louisiana Tech,Conference USA,West,13,7,6,0,8,4,4,0,7,3,4,0,5,3,2,0
2017,Louisville,ACC,Atlantic,13,8,5,0,8,4,4,0,6,4,2,0,5,3,2,0
2017,LSU,SEC,West,13,9,4,0,8,6,2,0,6,5,1,0,5,3,2,0
2017,Marshall,Conference USA,East,13,8,5,0,8,4,4,0,6,4,2,0,6,3,3,0
2017,Maryland,Big Ten,East,12,4,8,0,9,2,7,0,6,2,4,0,6,2,4,0
2017,Memphis,American Athletic,West,13,10,3,0,9,7,2,0,8,7,1,0,5,3,2,0
2017,Miami,ACC,Coastal,13,10,3,0,9,7,2,0,8,7,1,0,4,3,1,0
2017,Miami (OH),Mid-American,East,12,5,7,0,8,4,4,0,6,3,3,0,6,2,4,0
2017,Michigan,Big Ten,East,13,8,5,0,9,5,4,0,6,4,2,0,5,3,2,0
2017,Michigan State,Big Ten,East,13,10,3,0,9,7,2,0,7,6,1,0,5,3,2,0
2017,Middle Tennessee,Conference USA,East,13,7,6,0,8,4,4,0,6,4,2,0,6,2,4,0
2017,Minnesota,Big Ten,West,12,5,7,0,9,2,7,0,7,4,3,0,5,1,4,0
2017,Mississippi State,SEC,West,13,9,4,0,8,4,4,0,7,5,2,0,5,3,2,0
2017,Missouri,SEC,East,13,7,6,0,8,4,4,0,7,4,3,0,5,3,2,0
2017,Navy,American Athletic,West,13,7,6,0,8,4,4,0,6,5,1,0,6,2,4,0
2017,NC State,ACC,Atlantic,13,9,4,0,8,6,2,0,6,5,1,0,5,3,2,0
2017,Nebraska,Big Ten,West,12,4,8,0,9,3,6,0,7,2,5,0,5,2,3,0
2017,Nevada,Mountain West,West,12,3,9,0,8,3,5,0,6,3,3,0,6,0,6,0
2017,New Mexico,Mountain West,Mountain,12,3,9,0,8,1,7,0,6,2,4,0,6,1,5,0
2017,New Mexico State,Sun Belt,,13,7,6,0,8,4,4,0,5,3,2,0,7,3,4,0
2017,North Carolina,ACC,Coastal,12,3,9,0,8,1,7,0,7,1,6,0,5,2,3,0
2017,Northern Illinois,Mid-American,West,13,8,5,0,8,6,2,0,6,5,1,0,6,3,3,0
2017,North Texas,Conference USA,West,14,9,5,0,9,7,2,0,6,6,0,0,7,3,4,0
2017,Northwestern,Big Ten,West,13,10,3,0,9,7,2,0,7,6,1,0,5,3,2,0
2017,Notre Dame,FBS Independents,,13,10,3,0,0,0,0,0,7,6,1,0,5,3,2,0
2017,Ohio,Mid-American,East,13,9,4,0,8,5,3,0,6,5,1,0,6,3,3,0
2017,Ohio State,Big Ten,East,14,12,2,0,10,9,1,0,7,6,1,0,5,4,1,0
2017,Oklahoma,Big 12,,14,12,2,0,10,9,1,0,6,5,1,0,5,5,0,0
2017,Oklahoma State,Big 12,,13,10,3,0,9,6,3,0,6,3,3,0,6,6,0,0
2017,Old Dominion,Conference USA,East,12,5,7,0,8,3,5,0,6,3,3,0,6,2,4,0
2017,Ole Miss,SEC,West,12,6,6,0,8,3,5,0,7,4,3,0,5,2,3,0
2017,Oregon,Pac-12,North,13,7,6,0,9,4,5,0,7,6,1,0,5,1,4,0
2017,Oregon State,Pac-12,North,12,1,11,0,9,0,9,0,6,1,5,0,6,0,6,0
2017,Penn State,Big Ten,East,13,11,2,0,9,7,2,0,7,7,0,0,5,3,2,0
2017,Pittsburgh,ACC,Coastal,12,5,7,0,8,3,5,0,7,4,3,0,5,1,4,0
2017,Purdue,Big Ten,West,13,7,6,0,9,4,5,0,6,4,2,0,5,2,3,0
2017,Rice,Conference USA,West,12,1,11,0,8,1,7,0,5,0,5,0,6,1,5,0
2017,Rutgers,Big Ten,East,12,4,8,0,9,3,6,0,7,3,4,0,5,1,4,0
2017,San Diego State,Mountain West,West,13,10,3,0,8,6,2,0,7,5,2,0,5,5,0,0
2017,San José State,Mountain West,West,13,2,11,0,8,1,7,0,6,2,4,0,7,0,7,0
2017,SMU,American Athletic,West,13,7,6,0,8,4,4,0,7,6,1,0,5,1,4,0
2017,South Alabama,Sun Belt,,12,4,8,0,8,3,5,0,6,3,3,0,6,1,5,0
2017,South Carolina,SEC,East,13,9,4,0,8,5,3,0,7,5,2,0,4,2,2,0
2017,Southern Mississippi,Conference USA,West,13,8,5,0,8,6,2,0,6,3,3,0,6,5,1,0
2017,South Florida,American Athletic,East,12,10,2,0,8,6,2,0,6,5,1,0,5,4,1,0
2017,Stanford,Pac-12,North,14,9,5,0,10,7,3,0,6,6,0,0,5,2,3,0
2017,Syracuse,ACC,Atlantic,12,4,8,0,8,2,6,0,7,4,3,0,5,0,5,0
2017,TCU,Big 12,,14,11,3,0,10,7,3,0,6,6,0,0,6,4,2,0
2017,Temple,American Athletic,East,13,7,6,0,8,4,4,0,6,3,3,0,6,3,3,0
2017,Tennessee,SEC,East,12,4,8,0,8,0,8,0,7,3,4,0,4,0,4,0
2017,Texas,Big 12,,13,7,6,0,9,5,4,0,6,3,3,0,5,3,2,0
2017,Texas A&M,SEC,West,13,7,6,0,8,4,4,0,7,4,3,0,4,2,2,0
2017,Texas State,Sun Belt,,12,2,10,0,8,1,7,0,6,1,5,0,6,1,5,0
2017,Texas Tech,Big 12,,13,6,7,0,9,3,6,0,6,2,4,0,5,3,2,0
2017,Toledo,Mid-American,West,14,11,3,0,9,8,1,0,6,6,0,0,6,4,2,0
2017,Troy,Sun Belt,,13,11,2,0,8,7,1,0,6,5,1,0,6,5,1,0
2017,Tulane,American Athletic,West,12,5,7,0,8,3,5,0,6,4,2,0,6,1,5,0
2017,Tulsa,American Athletic,West,12,2,10,0,8,1,7,0,6,2,4,0,6,0,6,0
2017,UAB,Conference USA,West,13,8,5,0,8,6,2,0,6,6,0,0,6,2,4,0
2017,UCF,American Athletic,East,13,13,0,0,9,9,0,0,7,7,0,0,5,5,0,0
2017,UCLA,Pac-12,South,13,6,7,0,9,4,5,0,6,6,0,0,6,0,6,0
2017,UMass,FBS Independents,,12,4,8,0,0,0,0,0,5,2,3,0,6,1,5,0
2017,UNLV,Mountain West,West,12,5,7,0,8,4,4,0,6,2,4,0,6,3,3,0
2017,USC,Pac-12,South,14,11,3,0,10,9,1,0,7,7,0,0,5,3,2,0
2017,Utah,Pac-12,South,13,7,6,0,9,3,6,0,7,4,3,0,5,2,3,0
2017,Utah State,Mountain West,Mountain,13,6,7,0,8,4,4,0,6,3,3,0,6,3,3,0
2017,UTEP,Conference USA,West,12,0,12,0,8,0,8,0,5,0,5,0,7,0,7,0
2017,UT San Antonio,Conference USA,West,11,6,5,0,8,3,5,0,5,3,2,0,6,3,3,0
2017,Vanderbilt,SEC,East,12,5,7,0,8,1,7,0,7,3,4,0,5,2,3,0
2017,Virginia,ACC,Coastal,13,6,7,0,8,3,5,0,7,4,3,0,6,2,4,0
2017,Virginia Tech,ACC,Coastal,13,9,4,0,8,5,3,0,6,5,1,0,5,3,2,0
2017,Wake Forest,ACC,Atlantic,13,8,5,0,8,4,4,0,6,4,2,0,6,3,3,0
2017,Washington,Pac-12,North,13,10,3,0,9,7,2,0,7,7,0,0,5,3,2,0
2017,Washington State,Pac-12,North,13,9,4,0,9,6,3,0,7,7,0,0,5,2,3,0
2017,Western Kentucky,Conference USA,East,13,6,7,0,8,4,4,0,6,4,2,0,6,2,4,0
2017,Western Michigan,Mid-American,West,12,6,6,0,8,4,4,0,6,4,2,0,6,2,4,0
2017,West Virginia,Big 12,,13,7,6,0,9,5,4,0,6,4,2,0,5,3,2,0
2017,Wisconsin,Big Ten,West,14,13,1,0,10,9,1,0,7,7,0,0,6,6,0,0
2017,Wyoming,Mountain West,Mountain,13,8,5,0,8,5,3,0,7,5,2,0,5,2,3,0
2016,Air Force,Mountain West,Mountain,13,10,3,0,8,5,3,0,6,5,1,0,5,4,1,0
2016,Akron,Mid-American,East,12,5,7,0,8,3,5,0,6,2,4,0,6,3,3,0
2016,Alabama,SEC,West,15,14,1,0,9,9,0,0,7,7,0,0,4,4,0,0
2016,Appalachian State,Sun Belt,,13,10,3,0,8,7,1,0,6,5,1,0,6,4,2,0
2016,Arizona,Pac-12,South,12,3,9,0,9,1,8,0,7,3,4,0,4,0,4,0
2016,Arizona State,Pac-12,South,12,5,7,0,9,2,7,0,6,4,2,0,6,1,5,0
2016,Arkansas,SEC,West,13,7,6,0,8,3,5,0,7,5,2,0,4,2,2,0
2016,Arkansas State,Sun Belt,,13,8,5,0,8,7,1,0,6,4,2,0,7,4,3,0
2016,Army,FBS Independents,,13,8,5,0,0,0,0,0,5,3,2,0,5,3,2,0
2016,Auburn,SEC,West,13,8,5,0,8,5,3,0,8,6,2,0,4,2,2,0
2016,Ball State,Mid-American,West,12,4,8,0,8,1,7,0,5,1,4,0,7,3,4,0
2016,Baylor,Big 12,,13,7,6,0,9,3,6,0,6,4,2,0,5,2,3,0
2016,Boise State,Mountain West,Mountain,13,10,3,0,8,6,2,0,6,6,0,0,6,4,2,0
2016,Boston College,ACC,Atlantic,13,7,6,0,8,2,6,0,6,3,3,0,5,3,2,0
2016,Bowling Green,Mid-American,East,12,4,8,0,8,3,5,0,6,3,3,0,6,1,5,0
2016,Buffalo,Mid-American,East,12,2,10,0,8,1,7,0,6,2,4,0,6,0,6,0
2016,BYU,FBS Independents,,13,9,4,0,0,0,0,0,6,5,1,0,4,2,2,0
2016,California,Pac-12,North,12,5,7,0,9,3,6,0,6,4,2,0,5,0,5,0
2016,Central Michigan,Mid-American,West,13,6,7,0,8,3,5,0,6,4,2,0,6,2,4,0
2016,Charlotte,Conference USA,East,12,4,8,0,8,3,5,0,6,1,5,0,6,3,3,0
2016,Cincinnati,American Athletic,East,12,4,8,0,8,1,7,0,7,3,4,0,5,1,4,0
2016,Clemson,ACC,Atlantic,15,14,1,0,9,8,1,0,7,6,1,0,5,5,0,0
2016,Colorado,Pac-12,South,14,10,4,0,10,8,2,0,6,6,0,0,5,3,2,0
2016,Colorado State,Mountain West,Mountain,13,7,6,0,8,5,3,0,6,5,1,0,5,2,3,0
2016,Connecticut,American Athletic,East,12,3,9,0,8,1,7,0,7,3,4,0,5,0,5,0
2016,Duke,ACC,Coastal,12,4,8,0,8,1,7,0,6,3,3,0,6,1,5,0
2016,East Carolina,American Athletic,East,12,3,9,0,8,1,7,0,6,3,3,0,6,0,6,0
2016,Eastern Michigan,Mid-American,West,13,7,6,0,8,4,4,0,6,3,3,0,6,4,2,0
2016,Florida,SEC,East,13,9,4,0,9,6,3,0,5,5,0,0,5,2,3,0
2016,Florida Atlantic,Conference USA,East,12,3,9,0,8,2,6,0,6,2,4,0,6,1,5,0
2016,Florida International,Conference USA,East,12,4,8,0,8,4,4,0,7,2,5,0,5,2,3,0
2016,Florida State,ACC,Atlantic,13,10,3,0,8,5,3,0,6,4,2,0,5,4,1,0
2016,Fresno State,Mountain West,West,12,1,11,0,8,0,8,0,6,1,5,0,6,0,6,0
2016,Georgia,SEC,East,13,8,5,0,8,4,4,0,6,3,3,0,4,3,1,0
2016,Georgia Southern,Sun Belt,,12,5,7,0,8,4,4,0,5,3,2,0,7,2,5,0
2016,Georgia State,Sun Belt,,12,3,9,0,8,2,6,0,6,3,3,0,6,0,6,0
2016,Georgia Tech,ACC,Coastal,13,9,4,0,8,4,4,0,7,5,2,0,4,2,2,0
2016,Hawai'i,Mountain West,West,14,7,7,0,8,4,4,0,6,3,3,0,6,3,3,0
2016,Houston,American Athletic,West,13,9,4,0,8,5,3,0,6,6,0,0,5,2,3,0
2016,Idaho,Sun Belt,,13,9,4,0,8,6,2,0,5,4,1,0,7,4,3,0
2016,Illinois,Big Ten,West,12,3,9,0,9,2,7,0,7,2,5,0,5,1,4,0
2016,Indiana,Big Ten,East,13,6,7,0,9,4,5,0,7,4,3,0,5,2,3,0
2016,Iowa,Big Ten,West,13,8,5,0,9,6,3,0,7,4,3,0,5,4,1,0
2016,Iowa State,Big 12,,12,3,9,0,9,2,7,0,7,2,5,0,5,1,4,0
2016,Kansas,Big 12,,12,2,10,0,9,1,8,0,6,2,4,0,6,0,6,0
2016,Kansas State,Big 12,,13,9,4,0,9,6,3,0,6,5,1,0,6,3,3,0
2016,Kent State,Mid-American,East,12,3,9,0,8,2,6,0,6,1,5,0,6,2,4,0
2016,Kentucky,SEC,East,13,7,6,0,8,4,4,0,7,5,2,0,5,2,3,0
2016,Louisiana,Sun Belt,,13,6,7,0,8,5,3,0,6,3,3,0,6,3,3,0
2016,Louisiana Monroe,Sun Belt,,12,4,8,0,8,3,5,0,5,3,2,0,7,1,6,0
2016,Louisiana Tech,Conference USA,West,14,9,5,0,9,6,3,0,5,5,0,0,8,3,5,0
2016,Louisville,ACC,Atlantic,13,9,4,0,8,7,1,0,6,5,1,0,6,4,2,0
2016,LSU,SEC,West,12,8,4,0,8,5,3,0,7,5,2,0,3,2,1,0
2016,Marshall,Conference USA,East,12,3,9,0,8,2,6,0,7,3,4,0,5,0,5,0
2016,Maryland,Big Ten,East,13,6,7,0,9,3,6,0,6,4,2,0,6,2,4,0
2016,Memphis,American Athletic,West,13,8,5,0,8,5,3,0,7,5,2,0,5,3,2,0
2016,Miami,ACC,Coastal,13,9,4,0,8,5,3,0,6,4,2,0,6,4,2,0
2016,Miami (OH),Mid-American,East,13,6,7,0,8,6,2,0,6,3,3,0,6,3,3,0
2016,Michigan,Big Ten,East,13,10,3,0,9,7,2,0,8,8,0,0,4,2,2,0
2016,Michigan State,Big Ten,East,12,3,9,0,9,1,8,0,7,2,5,0,5,1,4,0
2016,Middle Tennessee,Conference USA,East,13,8,5,0,8,5,3,0,5,3,2,0,7,5,2,0
2016,Minnesota,Big Ten,West,13,9,4,0,9,5,4,0,7,6,1,0,5,2,3,0
2016,Mississippi State,SEC,West,13,6,7,0,8,3,5,0,6,3,3,0,6,2,4,0
2016,Missouri,SEC,East,12,4,8,0,8,2,6,0,7,4,3,0,5,0,5,0
2016,Navy,American Athletic,West,14,9,5,0,9,7,2,0,6,5,1,0,5,3,2,0
2016,NC State,ACC,Atlantic,13,7,6,0,8,3,5,0,7,4,3,0,5,2,3,0
2016,Nebraska,Big Ten,West,13,9,4,0,9,6,3,0,7,7,0,0,5,2,3,0
2016,Nevada,Mountain West,West,12,5,7,0,8,3,5,0,6,4,2,0,6,1,5,0
2016,New Mexico,Mountain West,Mountain,13,9,4,0,8,6,2,0,6,5,1,0,5,2,3,0
2016,New Mexico State,Sun Belt,,12,3,9,0,8,2,6,0,5,3,2,0,7,0,7,0
2016,North Carolina,ACC,Coastal,13,8,5,0,8,5,3,0,6,4,2,0,5,4,1,0
2016,Northern Illinois,Mid-American,West,12,5,7,0,8,5,3,0,5,2,3,0,6,3,3,0
2016,North Texas,Conference USA,West,13,5,8,0,8,3,5,0,6,3,3,0,6,2,4,0
2016,Northwestern,Big Ten,West,13,7,6,0,9,5,4,0,7,3,4,0,5,3,2,0
2016,Notre Dame,FBS Independents,,12,4,8,0,0,0,0,0,6,2,4,0,3,0,3,0
2016,Ohio,Mid-American,East,14,8,6,0,9,6,3,0,6,4,2,0,6,4,2,0
2016,Ohio State,Big Ten,East,13,11,2,0,9,8,1,0,7,7,0,0,5,4,1,0
2016,Oklahoma,Big 12,,13,11,2,0,9,9,0,0,6,5,1,0,4,4,0,0
2016,Oklahoma State,Big 12,,13,10,3,0,9,7,2,0,7,6,1,0,5,3,2,0
2016,Old Dominion,Conference USA,East,13,10,3,0,8,7,1,0,6,6,0,0,6,3,3,0
2016,Ole Miss,SEC,West,12,5,7,0,8,2,6,0,7,4,3,0,4,1,3,0
2016,Oregon,Pac-12,North,12,4,8,0,9,2,7,0,6,3,3,0,6,1,5,0
2016,Oregon State,Pac-12,North,12,4,8,0,9,3,6,0,7,4,3,0,5,0,5,0
2016,Penn State,Big Ten,East,14,11,3,0,10,9,1,0,7,7,0,0,5,3,2,0
2016,Pittsburgh,ACC,Coastal,13,8,5,0,8,5,3,0,7,6,1,0,5,2,3,0
2016,Purdue,Big Ten,West,12,3,9,0,9,1,8,0,7,2,5,0,5,1,4,0
2016,Rice,Conference USA,West,12,3,9,0,8,2,6,0,6,2,4,0,6,1,5,0
2016,Rutgers,Big Ten,East,12,2,10,0,9,0,9,0,7,2,5,0,5,0,5,0
2016,San Diego State,Mountain West,West,14,11,3,0,9,7,2,0,6,5,1,0,7,5,2,0
2016,San José State,Mountain West,West,12,4,8,0,8,3,5,0,6,3,3,0,6,1,5,0
2016,SMU,American Athletic,West,12,5,7,0,8,3,5,0,6,2,4,0,6,3,3,0
2016,South Alabama,Sun Belt,,13,6,7,0,8,2,6,0,7,5,2,0,5,1,4,0
2016,South Carolina,SEC,East,13,6,7,0,8,3,5,0,7,5,2,0,5,1,4,0
2016,Southern Mississippi,Conference USA,West,13,7,6,0,8,4,4,0,6,4,2,0,6,2,4,0
2016,South Florida,American Athletic,East,13,11,2,0,8,7,1,0,7,6,1,0,5,4,1,0
2016,Stanford,Pac-12,North,13,10,3,0,9,6,3,0,6,4,2,0,6,5,1,0
2016,Syracuse,ACC,Atlantic,12,4,8,0,8,2,6,0,6,2,4,0,5,2,3,0
2016,TCU,Big 12,,13,6,7,0,9,4,5,0,7,2,5,0,5,4,1,0
2016,Temple,American Athletic,East,14,10,4,0,9,8,1,0,7,6,1,0,6,4,2,0
2016,Tennessee,SEC,East,13,9,4,0,8,4,4,0,7,6,1,0,4,1,3,0
2016,Texas,Big 12,,12,5,7,0,9,3,6,0,6,4,2,0,5,1,4,0
2016,Texas A&M,SEC,West,13,8,5,0,8,4,4,0,7,5,2,0,4,2,2,0
2016,Texas State,Sun Belt,,12,2,10,0,8,0,8,0,6,1,5,0,6,1,5,0
2016,Texas Tech,Big 12,,12,5,7,0,9,3,6,0,6,3,3,0,5,1,4,0
2016,Toledo,Mid-American,West,13,9,4,0,8,6,2,0,6,5,1,0,5,3,2,0
2016,Troy,Sun Belt,,13,10,3,0,8,6,2,0,6,5,1,0,6,4,2,0
2016,Tulane,American Athletic,West,12,4,8,0,8,1,7,0,6,2,4,0,6,2,4,0
2016,Tulsa,American Athletic,West,13,10,3,0,8,6,2,0,6,6,0,0,6,3,3,0
2016,UCF,American Athletic,East,13,6,7,0,8,4,4,0,7,3,4,0,6,3,3,0
2016,UCLA,Pac-12,South,12,4,8,0,9,2,7,0,6,3,3,0,6,1,5,0
2016,UMass,FBS Independents,,12,2,10,0,0,0,0,0,6,2,4,0,6,0,6,0
2016,UNLV,Mountain West,West,12,4,8,0,8,3,5,0,6,3,3,0,6,1,5,0
2016,USC,Pac-12,South,13,10,3,0,9,7,2,0,6,6,0,0,5,3,2,0
2016,Utah,Pac-12,South,13,9,4,0,9,5,4,0,6,4,2,0,6,4,2,0
2016,Utah State,Mountain West,Mountain,12,3,9,0,8,1,7,0,6,3,3,0,6,0,6,0
2016,UTEP,Conference USA,West,12,4,8,0,8,2,6,0,7,3,4,0,5,1,4,0
2016,UT San Antonio,Conference USA,West,13,6,7,0,8,5,3,0,6,4,2,0,6,2,4,0
2016,Vanderbilt,SEC,East,13,6,7,0,8,3,5,0,6,4,2,0,6,2,4,0
2016,Virginia,ACC,Coastal,12,2,10,0,8,1,7,0,6,1,5,0,6,1,5,0
2016,Virginia Tech,ACC,Coastal,14,10,4,0,9,6,3,0,6,5,1,0,5,4,1,0
2016,Wake Forest,ACC,Atlantic,13,7,6,0,8,3,5,0,7,4,3,0,5,2,3,0
2016,Washington,Pac-12,North,14,12,2,0,10,9,1,0,7,6,1,0,5,5,0,0
2016,Washington State,Pac-12,North,13,8,5,0,9,7,2,0,7,5,2,0,5,3,2,0
2016,Western Kentucky,Conference USA,East,14,11,3,0,9,8,1,0,7,6,1,0,6,4,2,0
2016,Western Michigan,Mid-American,West,14,13,1,0,9,9,0,0,6,6,0,0,6,6,0,0
2016,West Virginia,Big 12,,13,10,3,0,9,7,2,0,7,6,1,0,4,3,1,0
2016,Wisconsin,Big Ten,West,14,11,3,0,10,7,3,0,6,5,1,0,5,4,1,0
2016,Wyoming,Mountain West,Mountain,14,8,6,0,9,6,3,0,7,6,1,0,6,2,4,0
2015,Air Force,Mountain West,Mountain,14,8,6,0,9,6,3,0,6,6,0,0,7,2,5,0
2015,Akron,Mid-American,East,13,8,5,0,8,5,3,0,6,3,3,0,6,4,2,0
2015,Alabama,SEC,West,15,14,1,0,9,8,1,0,7,6,1,0,4,4,0,0
2015,Appalachian State,Sun Belt,,13,11,2,0,8,7,1,0,6,5,1,0,6,5,1,0
2015,Arizona,Pac-12,South,13,7,6,0,9,3,6,0,6,4,2,0,6,2,4,0
2015,Arizona State,Pac-12,South,13,6,7,0,9,4,5,0,7,5,2,0,4,1,3,0
2015,Arkansas,SEC,West,13,8,5,0,8,5,3,0,7,4,3,0,4,3,1,0
2015,Arkansas State,Sun Belt,,13,9,4,0,8,8,0,0,6,5,1,0,6,4,2,0
2015,Army,FBS Independents,,12,2,10,0,0,0,0,0,6,1,5,0,5,1,4,0
2015,Auburn,SEC,West,13,7,6,0,8,2,6,0,7,3,4,0,4,2,2,0
2015,Ball State,Mid-American,West,12,3,9,0,8,2,6,0,6,2,4,0,6,1,5,0
2015,Baylor,Big 12,,13,10,3,0,9,6,3,0,6,4,2,0,5,4,1,0
2015,Boise State,Mountain West,Mountain,13,9,4,0,8,5,3,0,6,4,2,0,6,4,2,0
2015,Boston College,ACC,Atlantic,12,3,9,0,8,0,8,0,7,3,4,0,4,0,4,0
2015,Bowling Green,Mid-American,East,14,10,4,0,9,8,1,0,5,3,2,0,6,6,0,0
2015,Buffalo,Mid-American,East,12,5,7,0,8,3,5,0,6,2,4,0,6,3,3,0
2015,BYU,FBS Independents,,13,9,4,0,0,0,0,0,6,6,0,0,5,3,2,0
2015,California,Pac-12,North,13,8,5,0,9,4,5,0,6,5,1,0,6,2,4,0
2015,Central Michigan,Mid-American,West,13,7,6,0,8,6,2,0,6,4,2,0,6,3,3,0
2015,Charlotte,Conference USA,East,12,2,10,0,8,0,8,0,6,1,5,0,6,1,5,0
2015,Cincinnati,American Athletic,East,13,7,6,0,8,4,4,0,6,5,1,0,6,2,4,0
2015,Clemson,ACC,Atlantic,15,14,1,0,9,9,0,0,7,7,0,0,5,5,0,0
2015,Colorado,Pac-12,South,13,4,9,0,9,1,8,0,6,2,4,0,6,1,5,0
2015,Colorado State,Mountain West,Mountain,13,7,6,0,9,5,4,0,6,3,3,0,5,4,1,0
2015,Connecticut,American Athletic,East,13,6,7,0,8,4,4,0,6,4,2,0,6,2,4,0
2015,Duke,ACC,Coastal,13,8,5,0,8,4,4,0,6,3,3,0,6,4,2,0
2015,East Carolina,American Athletic,East,12,5,7,0,8,3,5,0,6,3,3,0,6,2,4,0
2015,Eastern Michigan,Mid-American,West,12,1,11,0,8,0,8,0,6,0,6,0,6,1,5,0
2015,Florida,SEC,East,14,10,4,0,9,7,2,0,7,6,1,0,4,3,1,0
2015,Florida Atlantic,Conference USA,East,12,3,9,0,8,3,5,0,6,1,5,0,6,2,4,0
2015,Florida International,Conference USA,East,12,5,7,0,8,3,5,0,5,4,1,0,7,1,6,0
2015,Florida State,ACC,Atlantic,13,10,3,0,8,6,2,0,7,7,0,0,5,3,2,0
2015,Fresno State,Mountain West,West,12,3,9,0,8,2,6,0,6,2,4,0,6,1,5,0
2015,Georgia,SEC,East,13,10,3,0,8,5,3,0,7,6,1,0,4,3,1,0
2015,Georgia Southern,Sun Belt,,13,9,4,0,8,6,2,0,6,5,1,0,6,3,3,0
2015,Georgia State,Sun Belt,,13,6,7,0,8,5,3,0,6,2,4,0,6,4,2,0
2015,Georgia Tech,ACC,Coastal,12,3,9,0,8,1,7,0,7,3,4,0,5,0,5,0
2015,Hawai'i,Mountain West,West,13,3,10,0,8,0,8,0,7,3,4,0,6,0,6,0
2015,Houston,American Athletic,West,14,13,1,0,9,8,1,0,8,8,0,0,5,4,1,0
2015,Idaho,Sun Belt,,12,4,8,0,8,3,5,0,6,3,3,0,6,1,5,0
2015,Illinois,Big Ten,West,12,5,7,0,8,2,6,0,6,4,2,0,5,1,4,0
2015,Indiana,Big Ten,East,13,6,7,0,8,2,6,0,7,3,4,0,5,3,2,0
2015,Iowa,Big Ten,West,14,12,2,0,9,8,1,0,7,7,0,0,5,5,0,0
2015,Iowa State,Big 12,,12,3,9,0,9,2,7,0,6,3,3,0,6,0,6,0
2015,Kansas,Big 12,,12,0,12,0,9,0,9,0,7,0,7,0,5,0,5,0
2015,Kansas State,Big 12,,13,6,7,0,9,3,6,0,7,4,3,0,5,2,3,0
2015,Kent State,Mid-American,East,12,3,9,0,8,2,6,0,6,2,4,0,6,1,5,0
2015,Kentucky,SEC,East,12,5,7,0,8,2,6,0,8,4,4,0,4,1,3,0
2015,Louisiana,Sun Belt,,12,4,8,0,8,3,5,0,6,3,3,0,6,1,5,0
2015,Louisiana Monroe,Sun Belt,,13,2,11,0,8,1,7,0,5,2,3,0,8,0,8,0
2015,Louisiana Tech,Conference USA,West,13,9,4,0,8,6,2,0,6,5,1,0,6,3,3,0
2015,Louisville,ACC,Atlantic,13,8,5,0,8,5,3,0,6,4,2,0,5,3,2,0
2015,LSU,SEC,West,12,9,3,0,8,5,3,0,7,6,1,0,4,2,2,0
2015,Marshall,Conference USA,East,13,10,3,0,8,6,2,0,6,6,0,0,6,3,3,0
2015,Maryland,Big Ten,East,12,3,9,0,8,1,7,0,6,2,4,0,5,1,4,0
2015,Memphis,American Athletic,West,13,9,4,0,8,5,3,0,6,5,1,0,6,4,2,0
2015,Miami,ACC,Coastal,13,8,5,0,8,5,3,0,6,5,1,0,6,3,3,0
2015,Miami (OH),Mid-American,East,12,3,9,0,8,2,6,0,6,2,4,0,6,1,5,0
2015,Michigan,Big Ten,East,13,10,3,0,8,6,2,0,7,5,2,0,5,4,1,0
2015,Michigan State,Big Ten,East,14,12,2,0,9,8,1,0,7,7,0,0,5,4,1,0
2015,Middle Tennessee,Conference USA,East,13,7,6,0,8,6,2,0,6,5,1,0,6,2,4,0
2015,Minnesota,Big Ten,West,13,6,7,0,8,2,6,0,7,3,4,0,5,2,3,0
2015,Mississippi State,SEC,West,13,9,4,0,8,4,4,0,7,4,3,0,5,4,1,0
2015,Missouri,SEC,East,12,5,7,0,8,1,7,0,6,3,3,0,5,1,4,0
2015,Navy,American Athletic,West,13,11,2,0,8,7,1,0,6,6,0,0,5,3,2,0
2015,NC State,ACC,Atlantic,13,7,6,0,8,3,5,0,6,3,3,0,6,4,2,0
2015,Nebraska,Big Ten,West,13,6,7,0,8,3,5,0,7,3,4,0,5,2,3,0
2015,Nevada,Mountain West,West,13,7,6,0,9,5,4,0,6,4,2,0,6,2,4,0
2015,New Mexico,Mountain West,Mountain,13,7,6,0,8,5,3,0,7,5,2,0,5,2,3,0
2015,New Mexico State,Sun Belt,,12,3,9,0,8,3,5,0,5,1,4,0,7,2,5,0
2015,North Carolina,ACC,Coastal,14,11,3,0,9,8,1,0,7,7,0,0,4,4,0,0
2015,Northern Illinois,Mid-American,West,14,8,6,0,9,6,3,0,6,5,1,0,6,3,3,0
2015,North Texas,Conference USA,West,12,1,11,0,8,1,7,0,5,1,4,0,7,0,7,0
2015,Northwestern,Big Ten,West,13,10,3,0,8,6,2,0,7,6,1,0,4,3,1,0
2015,Notre Dame,FBS Independents,,13,10,3,0,0,0,0,0,6,6,0,0,5,3,2,0
2015,Ohio,Mid-American,East,13,8,5,0,8,5,3,0,6,5,1,0,6,3,3,0
2015,Ohio State,Big Ten,East,13,12,1,0,8,7,1,0,7,6,1,0,5,5,0,0
2015,Oklahoma,Big 12,,13,11,2,0,9,8,1,0,6,6,0,0,5,5,0,0
2015,Oklahoma State,Big 12,,13,10,3,0,9,7,2,0,7,5,2,0,5,5,0,0
2015,Old Dominion,Conference USA,East,12,5,7,0,8,3,5,0,7,3,4,0,5,2,3,0
2015,Ole Miss,SEC,West,13,10,3,0,8,6,2,0,7,6,1,0,5,3,2,0
2015,Oregon,Pac-12,North,13,9,4,0,9,7,2,0,7,5,2,0,5,4,1,0
2015,Oregon State,Pac-12,North,12,2,10,0,9,0,9,0,6,2,4,0,6,0,6,0
2015,Penn State,Big Ten,East,13,7,6,0,8,4,4,0,7,6,1,0,4,0,4,0
2015,Pittsburgh,ACC,Coastal,13,8,5,0,8,6,2,0,6,3,3,0,6,5,1,0
2015,Purdue,Big Ten,West,12,2,10,0,8,1,7,0,7,2,5,0,5,0,5,0
2015,Rice,Conference USA,West,12,5,7,0,8,3,5,0,6,3,3,0,6,2,4,0
2015,Rutgers,Big Ten,East,12,4,8,0,8,1,7,0,7,2,5,0,5,2,3,0
2015,San Diego State,Mountain West,West,14,11,3,0,9,9,0,0,7,6,1,0,6,4,2,0
2015,San José State,Mountain West,West,13,6,7,0,8,4,4,0,6,3,3,0,6,2,4,0
2015,SMU,American Athletic,West,12,2,10,0,8,1,7,0,7,2,5,0,5,0,5,0
2015,South Alabama,Sun Belt,,12,5,7,0,8,3,5,0,6,3,3,0,6,2,4,0
2015,South Carolina,SEC,East,12,3,9,0,8,1,7,0,6,2,4,0,5,0,5,0
2015,Southern Mississippi,Conference USA,West,14,9,5,0,9,7,2,0,6,5,1,0,7,4,3,0
2015,South Florida,American Athletic,East,13,8,5,0,8,6,2,0,6,5,1,0,6,3,3,0
2015,Stanford,Pac-12,North,14,12,2,0,10,9,1,0,7,6,1,0,5,4,1,0
2015,Syracuse,ACC,Atlantic,12,4,8,0,8,2,6,0,7,4,3,0,5,0,5,0
2015,TCU,Big 12,,13,11,2,0,9,7,2,0,6,6,0,0,6,4,2,0
2015,Temple,American Athletic,East,14,10,4,0,9,7,2,0,6,5,1,0,7,5,2,0
2015,Tennessee,SEC,East,13,9,4,0,8,5,3,0,7,5,2,0,4,2,2,0
2015,Texas,Big 12,,12,5,7,0,9,4,5,0,6,3,3,0,5,1,4,0
2015,Texas A&M,SEC,West,13,8,5,0,8,4,4,0,7,5,2,0,3,1,2,0
2015,Texas State,Sun Belt,,12,3,9,0,8,2,6,0,6,3,3,0,6,0,6,0
2015,Texas Tech,Big 12,,13,7,6,0,9,4,5,0,6,4,2,0,5,3,2,0
2015,Toledo,Mid-American,West,12,10,2,0,8,6,2,0,6,4,2,0,5,5,0,0
2015,Troy,Sun Belt,,12,4,8,0,8,3,5,0,5,2,3,0,7,2,5,0
2015,Tulane,American Athletic,West,12,3,9,0,8,1,7,0,6,2,4,0,6,1,5,0
2015,Tulsa,American Athletic,West,13,6,7,0,8,3,5,0,6,3,3,0,6,3,3,0
2015,UCF,American Athletic,East,12,0,12,0,8,0,8,0,6,0,6,0,6,0,6,0
2015,UCLA,Pac-12,South,13,8,5,0,9,5,4,0,6,4,2,0,6,4,2,0
2015,UMass,Mid-American,East,12,3,9,0,8,2,6,0,6,1,5,0,6,2,4,0
2015,UNLV,Mountain West,West,12,3,9,0,8,2,6,0,6,2,4,0,6,1,5,0
2015,USC,Pac-12,South,14,8,6,0,10,6,4,0,7,5,2,0,5,3,2,0
2015,Utah,Pac-12,South,13,10,3,0,9,6,3,0,7,6,1,0,5,3,2,0
2015,Utah State,Mountain West,Mountain,13,6,7,0,8,5,3,0,6,5,1,0,6,1,5,0
2015,UTEP,Conference USA,West,12,5,7,0,8,3,5,0,5,3,2,0,7,2,5,0
2015,UT San Antonio,Conference USA,West,12,3,9,0,8,3,5,0,6,1,5,0,6,2,4,0
2015,Vanderbilt,SEC,East,12,4,8,0,8,2,6,0,6,3,3,0,6,1,5,0
2015,Virginia,ACC,Coastal,12,4,8,0,8,3,5,0,7,4,3,0,5,0,5,0
2015,Virginia Tech,ACC,Coastal,13,7,6,0,8,4,4,0,6,2,4,0,6,4,2,0
2015,Wake Forest,ACC,Atlantic,12,3,9,0,8,1,7,0,6,1,5,0,6,2,4,0
2015,Washington,Pac-12,North,13,7,6,0,9,4,5,0,7,4,3,0,5,2,3,0
2015,Washington State,Pac-12,North,13,9,4,0,9,6,3,0,6,4,2,0,6,4,2,0
2015,Western Kentucky,Conference USA,East,14,12,2,0,9,9,0,0,6,6,0,0,7,5,2,0
2015,Western Michigan,Mid-American,West,13,8,5,0,8,6,2,0,6,4,2,0,6,3,3,0
2015,West Virginia,Big 12,,13,8,5,0,9,4,5,0,7,6,1,0,5,1,4,0
2015,Wisconsin,Big Ten,West,13,10,3,0,8,6,2,0,7,5,2,0,4,4,0,0
2015,Wyoming,Mountain West,Mountain,12,2,10,0,8,2,6,0,6,2,4,0,6,0,6,0
2014,Air Force,Mountain West,Mountain,13,10,3,0,8,5,3,0,6,6,0,0,6,3,3,0
2014,Akron,Mid-American,East,12,5,7,0,8,3,5,0,6,4,2,0,6,1,5,0
2014,Alabama,SEC,West,14,12,2,0,9,8,1,0,7,7,0,0,4,3,1,0
2014,Appalachian State,Sun Belt,,12,7,5,0,8,6,2,0,6,4,2,0,6,3,3,0
2014,Arizona,Pac-12,South,14,10,4,0,10,7,3,0,7,6,1,0,5,4,1,0
2014,Arizona State,Pac-12,South,13,10,3,0,9,6,3,0,6,5,1,0,6,4,2,0
2014,Arkansas,SEC,West,13,7,6,0,8,2,6,0,7,5,2,0,4,1,3,0
2014,Arkansas State,Sun Belt,,13,7,6,0,8,5,3,0,6,5,1,0,6,2,4,0
2014,Army,FBS Independents,,12,4,8,0,0,0,0,0,5,3,2,0,5,0,5,0
2014,Auburn,SEC,West,13,8,5,0,8,4,4,0,7,6,1,0,5,2,3,0
2014,Ball State,Mid-American,West,12,5,7,0,8,4,4,0,6,3,3,0,6,2,4,0
2014,Baylor,Big 12,,13,11,2,0,9,8,1,0,6,6,0,0,5,4,1,0
2014,Boise State,Mountain West,Mountain,14,12,2,0,9,8,1,0,7,7,0,0,5,4,1,0
2014,Boston College,ACC,Atlantic,13,7,6,0,8,4,4,0,7,3,4,0,5,4,1,0
2014,Bowling Green,Mid-American,East,14,8,6,0,9,5,4,0,6,4,2,0,6,3,3,0
2014,Buffalo,Mid-American,East,11,5,6,0,7,3,4,0,6,4,2,0,5,1,4,0
2014,BYU,FBS Independents,,13,8,5,0,0,0,0,0,6,4,2,0,6,4,2,0
2014,California,Pac-12,North,12,5,7,0,9,3,6,0,7,2,5,0,5,3,2,0
2014,Central Michigan,Mid-American,West,13,7,6,0,8,5,3,0,6,3,3,0,6,4,2,0
2014,Cincinnati,American Athletic,,13,9,4,0,8,7,1,0,6,5,1,0,6,4,2,0
2014,Clemson,ACC,Atlantic,13,10,3,0,8,6,2,0,7,7,0,0,5,2,3,0
2014,Colorado,Pac-12,South,12,2,10,0,9,0,9,0,6,1,5,0,5,1,4,0
2014,Colorado State,Mountain West,Mountain,13,10,3,0,8,6,2,0,6,6,0,0,5,3,2,0
2014,Connecticut,American Athletic,,12,2,10,0,8,1,7,0,7,2,5,0,4,0,4,0
2014,Duke,ACC,Coastal,13,9,4,0,8,5,3,0,7,5,2,0,5,4,1,0
2014,East Carolina,American Athletic,,13,8,5,0,8,5,3,0,6,5,1,0,6,3,3,0
2014,Eastern Michigan,Mid-American,West,12,2,10,0,8,1,7,0,5,2,3,0,7,0,7,0
2014,Florida,SEC,East,12,7,5,0,8,4,4,0,6,3,3,0,4,2,2,0
2014,Florida Atlantic,Conference USA,East,12,3,9,0,8,2,6,0,5,3,2,0,7,0,7,0
2014,Florida International,Conference USA,East,12,4,8,0,8,3,5,0,8,3,5,0,4,1,3,0
2014,Florida State,ACC,Atlantic,14,13,1,0,9,9,0,0,7,7,0,0,4,4,0,0
2014,Fresno State,Mountain West,West,14,6,8,0,9,5,4,0,6,4,2,0,7,2,5,0
2014,Georgia,SEC,East,13,10,3,0,8,6,2,0,7,6,1,0,4,3,1,0
2014,Georgia Southern,Sun Belt,,12,9,3,0,8,8,0,0,5,5,0,0,7,4,3,0
2014,Georgia State,Sun Belt,,12,1,11,0,8,0,8,0,6,1,5,0,6,0,6,0
2014,Georgia Tech,ACC,Coastal,14,11,3,0,9,6,3,0,6,5,1,0,6,5,1,0
2014,Hawai'i,Mountain West,West,13,4,9,0,8,3,5,0,7,3,4,0,6,1,5,0
2014,Houston,American Athletic,,13,8,5,0,8,5,3,0,7,4,3,0,5,3,2,0
2014,Idaho,Sun Belt,,11,1,10,0,8,1,7,0,5,1,4,0,6,0,6,0
2014,Illinois,Big Ten,West,13,6,7,0,8,3,5,0,7,5,2,0,5,1,4,0
2014,Indiana,Big Ten,East,12,4,8,0,8,1,7,0,6,3,3,0,6,1,5,0
2014,Iowa,Big Ten,West,13,7,6,0,8,4,4,0,7,4,3,0,5,3,2,0
2014,Iowa State,Big 12,,12,2,10,0,9,0,9,0,7,1,6,0,5,1,4,0
2014,Kansas,Big 12,,12,3,9,0,9,1,8,0,6,3,3,0,6,0,6,0
2014,Kansas State,Big 12,,13,9,4,0,9,7,2,0,7,6,1,0,5,3,2,0
2014,Kent State,Mid-American,East,11,2,9,0,7,1,6,0,6,2,4,0,5,0,5,0
2014,Kentucky,SEC,East,12,5,7,0,8,2,6,0,7,5,2,0,5,0,5,0
2014,Louisiana,Sun Belt,,13,9,4,0,8,7,1,0,6,4,2,0,6,4,2,0
2014,Louisiana Monroe,Sun Belt,,12,4,8,0,8,3,5,0,5,3,2,0,7,1,6,0
2014,Louisiana Tech,Conference USA,West,14,9,5,0,9,7,2,0,5,4,1,0,8,4,4,0
2014,Louisville,ACC,Atlantic,13,9,4,0,8,5,3,0,6,5,1,0,6,4,2,0
2014,LSU,SEC,West,13,8,5,0,8,4,4,0,7,5,2,0,4,2,2,0
2014,Marshall,Conference USA,East,14,13,1,0,9,8,1,0,7,6,1,0,6,6,0,0
2014,Maryland,Big Ten,East,13,7,6,0,8,4,4,0,6,2,4,0,6,5,1,0
2014,Memphis,American Athletic,,13,10,3,0,8,7,1,0,6,5,1,0,6,4,2,0
2014,Miami,ACC,Coastal,13,6,7,0,8,3,5,0,7,5,2,0,5,1,4,0
2014,Miami (OH),Mid-American,East,12,2,10,0,8,2,6,0,6,2,4,0,6,0,6,0
2014,Michigan,Big Ten,East,12,5,7,0,8,3,5,0,7,4,3,0,5,1,4,0
2014,Michigan State,Big Ten,East,13,11,2,0,8,7,1,0,7,6,1,0,5,4,1,0
2014,Middle Tennessee,Conference USA,East,12,6,6,0,8,5,3,0,6,5,1,0,6,1,5,0
2014,Minnesota,Big Ten,West,13,8,5,0,8,5,3,0,7,6,1,0,5,2,3,0
2014,Mississippi State,SEC,West,13,10,3,0,8,6,2,0,7,7,0,0,5,3,2,0
2014,Missouri,SEC,East,14,11,3,0,9,7,2,0,7,5,2,0,5,5,0,0
2014,Navy,FBS Independents,,13,8,5,0,0,0,0,0,5,3,2,0,4,3,1,0
2014,NC State,ACC,Atlantic,13,8,5,0,8,3,5,0,7,4,3,0,5,3,2,0
2014,Nebraska,Big Ten,West,13,9,4,0,8,5,3,0,7,6,1,0,5,3,2,0
2014,Nevada,Mountain West,West,13,7,6,0,8,4,4,0,6,3,3,0,6,4,2,0
2014,New Mexico,Mountain West,Mountain,12,4,8,0,8,2,6,0,6,1,5,0,6,3,3,0
2014,New Mexico State,Sun Belt,,12,2,10,0,8,1,7,0,6,1,5,0,6,1,5,0
2014,North Carolina,ACC,Coastal,13,6,7,0,8,4,4,0,6,4,2,0,6,2,4,0
2014,Northern Illinois,Mid-American,West,14,11,3,0,9,8,1,0,5,4,1,0,7,6,1,0
2014,North Texas,Conference USA,West,12,4,8,0,8,2,6,0,6,4,2,0,6,0,6,0
2014,Northwestern,Big Ten,West,12,5,7,0,8,3,5,0,7,2,5,0,5,3,2,0
2014,Notre Dame,FBS Independents,,13,8,5,0,0,0,0,0,6,4,2,0,3,0,3,0
2014,Ohio,Mid-American,East,12,6,6,0,8,4,4,0,6,4,2,0,6,2,4,0
2014,Ohio State,Big Ten,East,15,14,1,0,9,9,0,0,7,6,1,0,4,4,0,0
2014,Oklahoma,Big 12,,13,8,5,0,9,5,4,0,6,3,3,0,5,4,1,0
2014,Oklahoma State,Big 12,,13,7,6,0,9,4,5,0,6,4,2,0,5,2,3,0
2014,Old Dominion,Conference USA,East,12,6,6,0,8,4,4,0,6,4,2,0,6,2,4,0
2014,Ole Miss,SEC,West,13,9,4,0,8,5,3,0,7,6,1,0,4,2,2,0
2014,Oregon,Pac-12,North,15,13,2,0,10,9,1,0,7,6,1,0,5,5,0,0
2014,Oregon State,Pac-12,North,12,5,7,0,9,2,7,0,7,3,4,0,5,2,3,0
2014,Penn State,Big Ten,East,13,7,6,0,8,2,6,0,7,3,4,0,4,2,2,0
2014,Pittsburgh,ACC,Coastal,13,6,7,0,8,4,4,0,7,3,4,0,5,3,2,0
2014,Purdue,Big Ten,West,12,3,9,0,8,1,7,0,7,2,5,0,4,1,3,0
2014,Rice,Conference USA,West,13,8,5,0,8,5,3,0,5,4,1,0,7,3,4,0
2014,Rutgers,Big Ten,East,13,8,5,0,8,3,5,0,6,4,2,0,6,3,3,0
2014,San Diego State,Mountain West,West,13,7,6,0,8,5,3,0,6,6,0,0,6,1,5,0
2014,San José State,Mountain West,West,12,3,9,0,8,2,6,0,5,2,3,0,7,1,6,0
2014,SMU,American Athletic,,12,1,11,0,8,1,7,0,6,0,6,0,6,1,5,0
2014,South Alabama,Sun Belt,,13,6,7,0,8,5,3,0,6,3,3,0,6,3,3,0
2014,South Carolina,SEC,East,13,7,6,0,8,3,5,0,7,4,3,0,5,2,3,0
2014,Southern Mississippi,Conference USA,West,12,3,9,0,8,1,7,0,6,2,4,0,6,1,5,0
2014,South Florida,American Athletic,,12,4,8,0,8,3,5,0,7,2,5,0,5,2,3,0
2014,Stanford,Pac-12,North,13,8,5,0,9,5,4,0,6,4,2,0,6,3,3,0
2014,Syracuse,ACC,Atlantic,12,3,9,0,8,1,7,0,6,1,5,0,5,2,3,0
2014,TCU,Big 12,,13,12,1,0,9,8,1,0,7,7,0,0,5,4,1,0
2014,Temple,American Athletic,,12,6,6,0,8,4,4,0,6,3,3,0,6,3,3,0
2014,Tennessee,SEC,East,13,7,6,0,8,3,5,0,7,4,3,0,5,2,3,0
2014,Texas,Big 12,,13,6,7,0,9,5,4,0,6,3,3,0,4,3,1,0
2014,Texas A&M,SEC,West,13,8,5,0,8,3,5,0,6,3,3,0,5,3,2,0
2014,Texas State,Sun Belt,,12,7,5,0,8,5,3,0,6,3,3,0,6,4,2,0
2014,Texas Tech,Big 12,,12,4,8,0,9,2,7,0,6,2,4,0,5,2,3,0
2014,Toledo,Mid-American,West,13,9,4,0,8,7,1,0,6,5,1,0,6,3,3,0
2014,Troy,Sun Belt,,12,3,9,0,8,3,5,0,6,2,4,0,6,1,5,0
2014,Tulane,American Athletic,,12,3,9,0,8,2,6,0,6,2,4,0,6,1,5,0
2014,Tulsa,American Athletic,,12,2,10,0,8,2,6,0,6,2,4,0,6,0,6,0
2014,UAB,Conference USA,East,12,6,6,0,8,4,4,0,6,3,3,0,6,3,3,0
2014,UCF,American Athletic,,13,9,4,0,8,7,1,0,6,6,0,0,5,3,2,0
2014,UCLA,Pac-12,South,13,10,3,0,9,6,3,0,6,3,3,0,5,5,0,0
2014,UMass,Mid-American,East,12,3,9,0,8,3,5,0,6,2,4,0,6,1,5,0
2014,UNLV,Mountain West,West,13,2,11,0,8,1,7,0,6,2,4,0,7,0,7,0
2014,USC,Pac-12,South,13,9,4,0,9,6,3,0,6,5,1,0,6,3,3,0
2014,Utah,Pac-12,South,13,9,4,0,9,5,4,0,6,3,3,0,6,5,1,0
2014,Utah State,Mountain West,Mountain,14,10,4,0,8,6,2,0,6,6,0,0,7,3,4,0
2014,UTEP,Conference USA,West,13,7,6,0,8,5,3,0,6,5,1,0,6,2,4,0
2014,UT San Antonio,Conference USA,West,12,4,8,0,8,3,5,0,6,3,3,0,6,1,5,0
2014,Vanderbilt,SEC,East,12,3,9,0,8,0,8,0,8,3,5,0,4,0,4,0
2014,Virginia,ACC,Coastal,12,5,7,0,8,3,5,0,7,5,2,0,5,0,5,0
2014,Virginia Tech,ACC,Coastal,13,7,6,0,8,3,5,0,7,3,4,0,5,3,2,0
2014,Wake Forest,ACC,Atlantic,12,3,9,0,8,1,7,0,6,3,3,0,6,0,6,0
2014,Washington,Pac-12,North,14,8,6,0,9,4,5,0,7,4,3,0,6,4,2,0
2014,Washington State,Pac-12,North,12,3,9,0,9,2,7,0,7,1,6,0,5,2,3,0
2014,Western Kentucky,Conference USA,East,13,8,5,0,8,4,4,0,6,5,1,0,6,2,4,0
2014,Western Michigan,Mid-American,West,13,8,5,0,8,6,2,0,5,3,2,0,7,5,2,0
2014,West Virginia,Big 12,,13,7,6,0,9,5,4,0,6,3,3,0,5,4,1,0
2014,Wisconsin,Big Ten,West,14,11,3,0,9,7,2,0,7,7,0,0,4,3,1,0
2014,Wyoming,Mountain West,Mountain,12,4,8,0,8,2,6,0,6,3,3,0,6,1,5,0
2013,Air Force,Mountain West,Mountain,12,2,10,0,8,0,8,0,7,2,5,0,5,0,5,0
2013,Akron,Mid-American,East,12,5,7,0,8,4,4,0,6,3,3,0,6,2,4,0
2013,Alabama,SEC,West,13,11,2,0,8,7,1,0,7,7,0,0,4,3,1,0
2013,Arizona,Pac-12,South,13,8,5,0,9,4,5,0,6,4,2,0,6,3,3,0
2013,Arizona State,Pac-12,South,14,10,4,0,10,8,2,0,8,7,1,0,4,3,1,0
2013,Arkansas,SEC,West,12,3,9,0,8,0,8,0,7,3,4,0,5,0,5,0
2013,Arkansas State,Sun Belt,,13,8,5,0,7,5,2,0,6,5,1,0,6,2,4,0
2013,Army,FBS Independents,,12,3,9,0,0,0,0,0,5,2,3,0,5,0,5,0
2013,Auburn,SEC,West,14,12,2,0,9,8,1,0,8,8,0,0,4,3,1,0
2013,Ball State,Mid-American,West,13,10,3,0,8,7,1,0,6,6,0,0,6,4,2,0
2013,Baylor,Big 12,,13,11,2,0,9,8,1,0,7,7,0,0,4,3,1,0
2013,Boise State,Mountain West,Mountain,13,8,5,0,8,6,2,0,6,6,0,0,6,2,4,0
2013,Boston College,ACC,Atlantic,13,7,6,0,8,4,4,0,6,5,1,0,6,2,4,0
2013,Bowling Green,Mid-American,East,14,10,4,0,9,8,1,0,6,5,1,0,6,4,2,0
2013,Buffalo,Mid-American,East,13,8,5,0,8,6,2,0,6,5,1,0,6,3,3,0
2013,BYU,FBS Independents,,13,8,5,0,0,0,0,0,6,5,1,0,6,3,3,0
2013,California,Pac-12,North,12,1,11,0,9,0,9,0,7,1,6,0,5,0,5,0
2013,Central Michigan,Mid-American,West,12,6,6,0,8,5,3,0,5,3,2,0,7,3,4,0
2013,Cincinnati,American Athletic,,13,9,4,0,8,6,2,0,6,5,1,0,6,4,2,0
2013,Clemson,ACC,Atlantic,13,11,2,0,8,7,1,0,7,6,1,0,5,4,1,0
2013,Colorado,Pac-12,South,12,4,8,0,9,1,8,0,6,3,3,0,5,0,5,0
2013,Colorado State,Mountain West,Mountain,14,8,6,0,8,5,3,0,6,4,2,0,6,3,3,0
2013,Connecticut,American Athletic,,12,3,9,0,8,3,5,0,7,2,5,0,5,1,4,0
2013,Duke,ACC,Coastal,14,10,4,0,9,6,3,0,7,5,2,0,5,5,0,0
2013,East Carolina,Conference USA,East,13,10,3,0,8,6,2,0,6,5,1,0,6,4,2,0
2013,Eastern Michigan,Mid-American,West,12,2,10,0,8,1,7,0,5,2,3,0,7,0,7,0
2013,Florida,SEC,East,12,4,8,0,8,3,5,0,6,3,3,0,5,1,4,0
2013,Florida Atlantic,Conference USA,East,12,6,6,0,8,4,4,0,5,3,2,0,7,3,4,0
2013,Florida International,Conference USA,East,12,1,11,0,8,1,7,0,6,0,6,0,6,1,5,0
2013,Florida State,ACC,Atlantic,14,14,0,0,9,9,0,0,7,7,0,0,5,5,0,0
2013,Fresno State,Mountain West,West,13,11,2,0,9,8,1,0,7,7,0,0,5,4,1,0
2013,Georgia,SEC,East,13,8,5,0,8,5,3,0,6,5,1,0,5,2,3,0
2013,Georgia State,Sun Belt,,12,0,12,0,7,0,7,0,7,0,7,0,5,0,5,0
2013,Georgia Tech,ACC,Coastal,13,7,6,0,8,5,3,0,7,5,2,0,5,2,3,0
2013,Hawai'i,Mountain West,West,12,1,11,0,8,0,8,0,6,1,5,0,6,0,6,0
2013,Houston,American Athletic,,13,8,5,0,8,5,3,0,6,4,2,0,5,3,2,0
2013,Idaho,FBS Independents,,12,1,11,0,0,0,0,0,5,1,4,0,7,0,7,0
2013,Illinois,Big Ten,Leaders,12,4,8,0,8,1,7,0,8,3,5,0,4,1,3,0
2013,Indiana,Big Ten,Leaders,12,5,7,0,8,3,5,0,8,5,3,0,4,0,4,0
2013,Iowa,Big Ten,Legends,13,8,5,0,8,5,3,0,7,4,3,0,5,4,1,0
2013,Iowa State,Big 12,,12,3,9,0,9,2,7,0,6,1,5,0,6,2,4,0
2013,Kansas,Big 12,,12,3,9,0,9,1,8,0,7,3,4,0,5,0,5,0
2013,Kansas State,Big 12,,13,8,5,0,9,5,4,0,8,5,3,0,4,2,2,0
2013,Kent State,Mid-American,East,12,4,8,0,8,3,5,0,5,2,3,0,7,2,5,0
2013,Kentucky,SEC,East,12,2,10,0,8,0,8,0,7,2,5,0,4,0,4,0
2013,Louisiana,Sun Belt,,13,9,4,0,7,5,2,0,5,4,1,0,7,4,3,0
2013,Louisiana Monroe,Sun Belt,,12,6,6,0,7,4,3,0,5,2,3,0,7,4,3,0
2013,Louisiana Tech,Conference USA,West,12,4,8,0,8,3,5,0,5,2,3,0,6,2,4,0
2013,Louisville,American Athletic,,13,12,1,0,8,7,1,0,7,6,1,0,5,5,0,0
2013,LSU,SEC,West,13,10,3,0,8,5,3,0,7,7,0,0,4,1,3,0
2013,Marshall,Conference USA,East,14,10,4,0,9,7,2,0,6,6,0,0,7,3,4,0
2013,Maryland,ACC,Atlantic,13,7,6,0,8,3,5,0,7,4,3,0,5,3,2,0
2013,Memphis,American Athletic,,12,3,9,0,8,1,7,0,7,2,5,0,5,1,4,0
2013,Miami,ACC,Coastal,13,9,4,0,8,5,3,0,7,6,1,0,5,3,2,0
2013,Miami (OH),Mid-American,East,12,0,12,0,8,0,8,0,5,0,5,0,7,0,7,0
2013,Michigan,Big Ten,Legends,13,7,6,0,8,3,5,0,7,5,2,0,5,2,3,0
2013,Michigan State,Big Ten,Legends,14,13,1,0,9,9,0,0,7,7,0,0,5,4,1,0
2013,Middle Tennessee,Conference USA,East,13,8,5,0,8,6,2,0,6,5,1,0,6,3,3,0
2013,Minnesota,Big Ten,Legends,13,8,5,0,8,4,4,0,7,5,2,0,5,3,2,0
2013,Mississippi State,SEC,West,13,7,6,0,8,3,5,0,7,5,2,0,4,1,3,0
2013,Missouri,SEC,East,14,12,2,0,9,7,2,0,7,6,1,0,5,5,0,0
2013,Navy,FBS Independents,,13,9,4,0,0,0,0,0,5,5,0,0,6,2,4,0
2013,NC State,ACC,Atlantic,12,3,9,0,8,0,8,0,8,3,5,0,4,0,4,0
2013,Nebraska,Big Ten,Legends,13,9,4,0,8,5,3,0,8,5,3,0,4,3,1,0
2013,Nevada,Mountain West,West,12,4,8,0,8,3,5,0,6,4,2,0,6,0,6,0
2013,New Mexico,Mountain West,Mountain,12,3,9,0,8,1,7,0,6,2,4,0,6,1,5,0
2013,New Mexico State,FBS Independents,,12,2,10,0,0,0,0,0,7,2,5,0,5,0,5,0
2013,North Carolina,ACC,Coastal,13,7,6,0,8,4,4,0,7,4,3,0,5,2,3,0
2013,Northern Illinois,Mid-American,West,14,12,2,0,9,8,1,0,5,5,0,0,7,7,0,0
2013,North Texas,Conference USA,West,13,9,4,0,8,6,2,0,6,5,1,0,6,3,3,0
2013,Northwestern,Big Ten,Legends,12,5,7,0,8,1,7,0,7,3,4,0,5,2,3,0
2013,Notre Dame,FBS Independents,,13,9,4,0,0,0,0,0,6,5,1,0,5,2,3,0
2013,Ohio,Mid-American,East,13,7,6,0,8,4,4,0,7,5,2,0,5,2,3,0
2013,Ohio State,Big Ten,Leaders,14,12,2,0,9,8,1,0,7,7,0,0,5,5,0,0
2013,Oklahoma,Big 12,,13,11,2,0,9,7,2,0,6,6,0,0,5,4,1,0
2013,Oklahoma State,Big 12,,13,10,3,0,9,7,2,0,6,5,1,0,5,4,1,0
2013,Ole Miss,SEC,West,13,8,5,0,8,3,5,0,7,5,2,0,5,2,3,0
2013,Oregon,Pac-12,North,13,11,2,0,9,7,2,0,7,7,0,0,5,3,2,0
2013,Oregon State,Pac-12,North,13,7,6,0,9,4,5,0,6,2,4,0,6,4,2,0
2013,Penn State,Big Ten,Leaders,12,7,5,0,8,4,4,0,7,5,2,0,4,1,3,0
2013,Pittsburgh,ACC,Coastal,13,7,6,0,8,3,5,0,7,4,3,0,5,2,3,0
2013,Purdue,Big Ten,Leaders,12,1,11,0,8,0,8,0,7,1,6,0,5,0,5,0
2013,Rice,Conference USA,West,14,10,4,0,9,8,1,0,6,6,0,0,6,4,2,0
2013,Rutgers,American Athletic,,13,6,7,0,8,3,5,0,7,5,2,0,5,1,4,0
2013,San Diego State,Mountain West,West,13,8,5,0,8,6,2,0,6,3,3,0,6,4,2,0
2013,San José State,Mountain West,West,12,6,6,0,8,5,3,0,6,3,3,0,6,3,3,0
2013,SMU,American Athletic,,12,5,7,0,8,4,4,0,6,3,3,0,6,2,4,0
2013,South Alabama,Sun Belt,,12,6,6,0,7,4,3,0,6,4,2,0,6,2,4,0
2013,South Carolina,SEC,East,13,11,2,0,8,6,2,0,7,7,0,0,5,3,2,0
2013,Southern Mississippi,Conference USA,East,12,1,11,0,8,1,7,0,5,0,5,0,7,1,6,0
2013,South Florida,American Athletic,,12,2,10,0,8,2,6,0,7,1,6,0,5,1,4,0
2013,Stanford,Pac-12,North,14,11,3,0,10,8,2,0,7,7,0,0,6,4,2,0
2013,Syracuse,ACC,Atlantic,13,7,6,0,8,4,4,0,6,4,2,0,5,2,3,0
2013,TCU,Big 12,,12,4,8,0,9,2,7,0,6,3,3,0,5,1,4,0
2013,Temple,American Athletic,,12,2,10,0,8,1,7,0,6,1,5,0,6,1,5,0
2013,Tennessee,SEC,East,12,5,7,0,8,2,6,0,7,4,3,0,5,1,4,0
2013,Texas,Big 12,,13,8,5,0,9,7,2,0,6,4,2,0,5,3,2,0
2013,Texas A&M,SEC,West,13,9,4,0,8,4,4,0,8,6,2,0,4,2,2,0
2013,Texas State,Sun Belt,,12,6,6,0,7,2,5,0,6,4,2,0,6,2,4,0
2013,Texas Tech,Big 12,,13,8,5,0,9,4,5,0,6,4,2,0,5,3,2,0
2013,Toledo,Mid-American,West,12,7,5,0,8,5,3,0,6,5,1,0,6,2,4,0
2013,Troy,Sun Belt,,12,6,6,0,7,4,3,0,5,4,1,0,7,2,5,0
2013,Tulane,Conference USA,West,13,7,6,0,8,5,3,0,6,5,1,0,6,2,4,0
2013,Tulsa,Conference USA,West,12,3,9,0,8,2,6,0,6,1,5,0,6,2,4,0
2013,UAB,Conference USA,East,12,2,10,0,8,1,7,0,5,1,4,0,7,1,6,0
2013,UCF,American Athletic,,13,12,1,0,8,8,0,0,6,5,1,0,6,6,0,0
2013,UCLA,Pac-12,South,13,10,3,0,9,6,3,0,6,5,1,0,6,4,2,0
2013,UMass,Mid-American,East,12,1,11,0,8,1,7,0,6,1,5,0,6,0,6,0
2013,UNLV,Mountain West,West,13,7,6,0,8,5,3,0,7,4,3,0,5,3,2,0
2013,USC,Pac-12,South,14,10,4,0,9,6,3,0,7,5,2,0,6,4,2,0
2013,Utah,Pac-12,South,12,5,7,0,9,2,7,0,7,4,3,0,5,1,4,0
2013,Utah State,Mountain West,Mountain,14,9,5,0,9,7,2,0,6,4,2,0,7,4,3,0
2013,UTEP,Conference USA,West,12,2,10,0,8,1,7,0,5,1,4,0,7,1,6,0
2013,UT San Antonio,Conference USA,West,12,7,5,0,8,6,2,0,6,3,3,0,6,4,2,0
2013,Vanderbilt,SEC,East,13,9,4,0,8,4,4,0,7,5,2,0,5,3,2,0
2013,Virginia,ACC,Coastal,12,2,10,0,8,0,8,0,8,2,6,0,4,0,4,0
2013,Virginia Tech,ACC,Coastal,13,8,5,0,8,5,3,0,6,4,2,0,5,4,1,0
2013,Wake Forest,ACC,Atlantic,12,4,8,0,8,2,6,0,6,3,3,0,6,1,5,0
2013,Washington,Pac-12,North,13,9,4,0,9,5,4,0,7,6,1,0,5,2,3,0
2013,Washington State,Pac-12,North,13,6,7,0,9,4,5,0,6,3,3,0,6,3,3,0
2013,Western Kentucky,Sun Belt,,12,8,4,0,7,4,3,0,5,3,2,0,6,4,2,0
2013,Western Michigan,Mid-American,West,12,1,11,0,8,1,7,0,5,0,5,0,7,1,6,0
2013,West Virginia,Big 12,,12,4,8,0,9,2,7,0,6,3,3,0,6,1,5,0
2013,Wisconsin,Big Ten,Leaders,13,9,4,0,8,6,2,0,7,6,1,0,5,3,2,0
2013,Wyoming,Mountain West,Mountain,12,5,7,0,8,3,5,0,6,4,2,0,6,1,5,0
2012,Air Force,Mountain West,,13,6,7,0,8,5,3,0,6,5,1,0,6,1,5,0
2012,Akron,Mid-American,East,12,1,11,0,8,0,8,0,6,1,5,0,6,0,6,0
2012,Alabama,SEC,West,14,13,1,0,9,8,1,0,7,6,1,0,4,4,0,0
2012,Arizona,Pac-12,South,13,8,5,0,9,4,5,0,8,6,2,0,4,1,3,0
2012,Arizona State,Pac-12,South,13,8,5,0,9,5,4,0,6,4,2,0,6,3,3,0
2012,Arkansas,SEC,West,12,4,8,0,8,2,6,0,7,3,4,0,4,1,3,0
2012,Arkansas State,Sun Belt,,13,10,3,0,8,7,1,0,6,5,1,0,6,4,2,0
2012,Army,FBS Independents,,12,2,10,0,0,0,0,0,7,2,5,0,4,0,4,0
2012,Auburn,SEC,West,12,3,9,0,8,0,8,0,7,3,4,0,4,0,4,0
2012,Ball State,Mid-American,West,13,9,4,0,8,6,2,0,5,4,1,0,7,5,2,0
2012,Baylor,Big 12,,13,8,5,0,9,4,5,0,6,5,1,0,5,1,4,0
2012,Boise State,Mountain West,,13,11,2,0,8,7,1,0,6,5,1,0,6,5,1,0
2012,Boston College,ACC,Atlantic,12,2,10,0,8,1,7,0,6,2,4,0,6,0,6,0
2012,Bowling Green,Mid-American,East,13,8,5,0,8,6,2,0,6,5,1,0,6,3,3,0
2012,Buffalo,Mid-American,East,12,4,8,0,8,3,5,0,6,3,3,0,6,1,5,0
2012,BYU,FBS Independents,,13,8,5,0,0,0,0,0,6,5,1,0,6,2,4,0
2012,California,Pac-12,North,12,3,9,0,9,2,7,0,7,2,5,0,5,1,4,0
2012,Central Michigan,Mid-American,West,13,7,6,0,8,4,4,0,7,3,4,0,5,3,2,0
2012,Cincinnati,Big East,,13,10,3,0,7,5,2,0,7,6,1,0,4,2,2,0
2012,Clemson,ACC,Atlantic,13,11,2,0,8,7,1,0,7,6,1,0,4,3,1,0
2012,Colorado,Pac-12,South,12,1,11,0,9,1,8,0,6,0,6,0,5,1,4,0
2012,Colorado State,Mountain West,,12,4,8,0,8,3,5,0,6,3,3,0,5,0,5,0
2012,Connecticut,Big East,,12,5,7,0,7,2,5,0,6,3,3,0,6,2,4,0
2012,Duke,ACC,Coastal,13,6,7,0,8,3,5,0,7,5,2,0,5,1,4,0
2012,East Carolina,Conference USA,East,13,8,5,0,8,7,1,0,6,5,1,0,6,3,3,0
2012,Eastern Michigan,Mid-American,West,12,2,10,0,8,1,7,0,6,1,5,0,6,1,5,0
2012,Florida,SEC,East,13,11,2,0,8,7,1,0,7,7,0,0,4,4,0,0
2012,Florida Atlantic,Sun Belt,,12,3,9,0,8,2,6,0,5,2,3,0,7,1,6,0
2012,Florida International,Sun Belt,,12,3,9,0,8,2,6,0,6,1,5,0,6,2,4,0
2012,Florida State,ACC,Atlantic,14,12,2,0,9,8,1,0,7,6,1,0,5,4,1,0
2012,Fresno State,Mountain West,,13,9,4,0,8,7,1,0,6,6,0,0,6,3,3,0
2012,Georgia,SEC,East,14,12,2,0,9,7,2,0,7,7,0,0,4,3,1,0
2012,Georgia Tech,ACC,Coastal,14,7,7,0,9,5,4,0,7,4,3,0,5,2,3,0
2012,Hawai'i,Mountain West,,12,3,9,0,8,1,7,0,6,3,3,0,6,0,6,0
2012,Houston,Conference USA,West,12,5,7,0,8,4,4,0,7,4,3,0,4,0,4,0
2012,Idaho,Western Athletic,,12,1,11,0,6,1,5,0,5,1,4,0,7,0,7,0
2012,Illinois,Big Ten,Leaders,12,2,10,0,8,0,8,0,7,2,5,0,5,0,5,0
2012,Indiana,Big Ten,Leaders,12,4,8,0,8,2,6,0,6,2,4,0,6,2,4,0
2012,Iowa,Big Ten,Legends,12,4,8,0,8,2,6,0,7,2,5,0,4,1,3,0
2012,Iowa State,Big 12,,13,6,7,0,9,3,6,0,7,3,4,0,5,3,2,0
2012,Kansas,Big 12,,12,1,11,0,9,0,9,0,6,1,5,0,6,0,6,0
2012,Kansas State,Big 12,,13,11,2,0,9,8,1,0,7,7,0,0,5,4,1,0
2012,Kent State,Mid-American,East,14,11,3,0,9,8,1,0,5,5,0,0,7,6,1,0
2012,Kentucky,SEC,East,12,2,10,0,8,0,8,0,7,2,5,0,5,0,5,0
2012,Louisiana,Sun Belt,,13,9,4,0,8,6,2,0,6,5,1,0,6,3,3,0
2012,Louisiana Monroe,Sun Belt,,13,8,5,0,8,6,2,0,5,3,2,0,6,4,2,0
2012,Louisiana Tech,Western Athletic,,12,9,3,0,6,4,2,0,6,4,2,0,6,5,1,0
2012,Louisville,Big East,,13,11,2,0,7,5,2,0,7,6,1,0,5,4,1,0
2012,LSU,SEC,West,13,10,3,0,8,6,2,0,8,7,1,0,4,3,1,0
2012,Marshall,Conference USA,East,12,5,7,0,8,4,4,0,6,3,3,0,6,2,4,0
2012,Maryland,ACC,Atlantic,12,4,8,0,8,2,6,0,6,2,4,0,6,2,4,0
2012,Memphis,Conference USA,East,12,4,8,0,8,4,4,0,6,3,3,0,6,1,5,0
2012,Miami,ACC,Coastal,12,7,5,0,8,5,3,0,6,4,2,0,6,3,3,0
2012,Miami (OH),Mid-American,East,12,4,8,0,8,3,5,0,5,3,2,0,7,1,6,0
2012,Michigan,Big Ten,Legends,13,8,5,0,8,6,2,0,6,6,0,0,5,2,3,0
2012,Michigan State,Big Ten,Legends,13,7,6,0,8,3,5,0,7,2,5,0,5,4,1,0
2012,Middle Tennessee,Sun Belt,,12,8,4,0,8,6,2,0,5,3,2,0,7,5,2,0
2012,Minnesota,Big Ten,Legends,13,6,7,0,8,2,6,0,7,4,3,0,5,2,3,0
2012,Mississippi State,SEC,West,13,8,5,0,8,4,4,0,7,6,1,0,5,2,3,0
2012,Missouri,SEC,East,12,5,7,0,8,2,6,0,7,3,4,0,5,2,3,0
2012,Navy,FBS Independents,,13,8,5,0,0,0,0,0,5,4,1,0,5,3,2,0
2012,NC State,ACC,Atlantic,13,7,6,0,8,4,4,0,6,5,1,0,5,2,3,0
2012,Nebraska,Big Ten,Legends,14,10,4,0,9,7,2,0,7,7,0,0,5,3,2,0
2012,Nevada,Mountain West,,13,7,6,0,8,4,4,0,6,2,4,0,6,5,1,0
2012,New Mexico,Mountain West,,13,4,9,0,8,1,7,0,6,2,4,0,7,2,5,0
2012,New Mexico State,Western Athletic,,12,1,11,0,6,0,6,0,6,1,5,0,6,0,6,0
2012,North Carolina,ACC,Coastal,12,8,4,0,8,5,3,0,7,6,1,0,5,2,3,0
2012,Northern Illinois,Mid-American,West,14,12,2,0,9,9,0,0,6,6,0,0,5,5,0,0
2012,North Texas,Sun Belt,,12,4,8,0,8,3,5,0,5,3,2,0,7,1,6,0
2012,Northwestern,Big Ten,Legends,13,10,3,0,8,5,3,0,7,6,1,0,5,3,2,0
2012,Notre Dame,FBS Independents,,13,12,1,0,0,0,0,0,7,7,0,0,4,4,0,0
2012,Ohio,Mid-American,East,13,9,4,0,8,4,4,0,6,5,1,0,6,3,3,0
2012,Ohio State,Big Ten,Leaders,12,12,0,0,8,8,0,0,8,8,0,0,4,4,0,0
2012,Oklahoma,Big 12,,13,10,3,0,9,8,1,0,6,4,2,0,5,5,0,0
2012,Oklahoma State,Big 12,,13,8,5,0,9,5,4,0,7,6,1,0,5,1,4,0
2012,Ole Miss,SEC,West,13,7,6,0,8,3,5,0,7,4,3,0,5,2,3,0
2012,Oregon,Pac-12,North,13,12,1,0,9,8,1,0,7,6,1,0,5,5,0,0
2012,Oregon State,Pac-12,North,13,9,4,0,9,6,3,0,7,6,1,0,5,3,2,0
2012,Penn State,Big Ten,Leaders,12,8,4,0,8,6,2,0,7,5,2,0,5,3,2,0
2012,Pittsburgh,Big East,,13,6,7,0,7,3,4,0,6,4,2,0,6,2,4,0
2012,Purdue,Big Ten,Leaders,13,6,7,0,8,3,5,0,7,4,3,0,5,2,3,0
2012,Rice,Conference USA,West,13,7,6,0,8,4,4,0,5,3,2,0,6,3,3,0
2012,Rutgers,Big East,,13,9,4,0,7,5,2,0,6,4,2,0,6,5,1,0
2012,San Diego State,Mountain West,,13,9,4,0,8,7,1,0,7,6,1,0,5,3,2,0
2012,San José State,Western Athletic,,13,11,2,0,6,5,1,0,6,5,1,0,6,5,1,0
2012,SMU,Conference USA,West,13,7,6,0,8,5,3,0,7,5,2,0,5,1,4,0
2012,South Alabama,Sun Belt,,13,2,11,0,8,1,7,0,6,2,4,0,7,0,7,0
2012,South Carolina,SEC,East,13,11,2,0,8,6,2,0,7,7,0,0,5,3,2,0
2012,Southern Mississippi,Conference USA,East,12,0,12,0,8,0,8,0,6,0,6,0,6,0,6,0
2012,South Florida,Big East,,12,3,9,0,7,1,6,0,6,2,4,0,6,1,5,0
2012,Stanford,Pac-12,North,14,12,2,0,10,9,1,0,7,7,0,0,6,4,2,0
2012,Syracuse,Big East,,13,8,5,0,7,5,2,0,5,4,1,0,6,3,3,0
2012,TCU,Big 12,,13,7,6,0,9,4,5,0,6,2,4,0,6,5,1,0
2012,Temple,Big East,,11,4,7,0,7,2,5,0,6,2,4,0,5,2,3,0
2012,Tennessee,SEC,East,12,5,7,0,8,1,7,0,7,4,3,0,4,0,4,0
2012,Texas,Big 12,,13,9,4,0,9,5,4,0,6,4,2,0,5,4,1,0
2012,Texas A&M,SEC,West,13,11,2,0,8,6,2,0,6,4,2,0,6,6,0,0
2012,Texas State,Western Athletic,,12,4,8,0,6,2,4,0,6,3,3,0,6,1,5,0
2012,Texas Tech,Big 12,,13,8,5,0,9,4,5,0,6,4,2,0,5,3,2,0
2012,Toledo,Mid-American,West,13,9,4,0,8,6,2,0,6,5,1,0,6,4,2,0
2012,Troy,Sun Belt,,12,5,7,0,8,3,5,0,6,2,4,0,6,3,3,0
2012,Tulane,Conference USA,West,12,2,10,0,8,2,6,0,7,2,5,0,5,0,5,0
2012,Tulsa,Conference USA,West,14,11,3,0,9,8,1,0,7,7,0,0,6,3,3,0
2012,UAB,Conference USA,East,12,3,9,0,8,2,6,0,6,2,4,0,6,1,5,0
2012,UCF,Conference USA,East,14,10,4,0,9,7,2,0,6,5,1,0,7,4,3,0
2012,UCLA,Pac-12,South,14,9,5,0,10,6,4,0,7,5,2,0,6,4,2,0
2012,UMass,Mid-American,East,12,1,11,0,8,1,7,0,5,0,5,0,7,1,6,0
2012,UNLV,Mountain West,,13,2,11,0,8,2,6,0,7,2,5,0,6,0,6,0
2012,USC,Pac-12,South,13,7,6,0,9,5,4,0,6,4,2,0,5,2,3,0
2012,Utah,Pac-12,South,12,5,7,0,9,3,6,0,6,4,2,0,6,1,5,0
2012,Utah State,Western Athletic,,13,11,2,0,6,6,0,0,6,6,0,0,6,4,2,0
2012,UTEP,Conference USA,West,12,3,9,0,8,2,6,0,6,2,4,0,6,1,5,0
2012,UT San Antonio,Western Athletic,,12,8,4,0,6,3,3,0,6,4,2,0,6,4,2,0
2012,Vanderbilt,SEC,East,13,9,4,0,8,5,3,0,6,4,2,0,6,4,2,0
2012,Virginia,ACC,Coastal,12,4,8,0,8,2,6,0,7,3,4,0,5,1,4,0
2012,Virginia Tech,ACC,Coastal,13,7,6,0,8,4,4,0,6,5,1,0,5,1,4,0
2012,Wake Forest,ACC,Atlantic,12,5,7,0,8,3,5,0,7,4,3,0,5,1,4,0
2012,Washington,Pac-12,North,13,7,6,0,9,5,4,0,6,5,1,0,6,2,4,0
2012,Washington State,Pac-12,North,12,3,9,0,9,1,8,0,6,2,4,0,6,1,5,0
2012,Western Kentucky,Sun Belt,,13,7,6,0,8,4,4,0,6,3,3,0,6,4,2,0
2012,Western Michigan,Mid-American,West,12,4,8,0,8,2,6,0,6,3,3,0,6,1,5,0
2012,West Virginia,Big 12,,13,7,6,0,9,4,5,0,7,4,3,0,4,2,2,0
2012,Wisconsin,Big Ten,Leaders,14,8,6,0,9,5,4,0,7,5,2,0,5,2,3,0
2012,Wyoming,Mountain West,,12,4,8,0,8,3,5,0,6,1,5,0,6,3,3,0
2011,Air Force,Mountain West,,13,7,6,0,7,3,4,0,7,4,3,0,5,3,2,0
2011,Akron,Mid-American,East,12,1,11,0,8,0,8,0,6,1,5,0,6,0,6,0
2011,Alabama,SEC,West,13,12,1,0,9,8,1,0,7,6,1,0,5,5,0,0
2011,Arizona,Pac-12,South,12,4,8,0,9,2,7,0,6,3,3,0,6,1,5,0
2011,Arizona State,Pac-12,South,13,6,7,0,9,4,5,0,7,5,2,0,5,1,4,0
2011,Arkansas,SEC,West,13,11,2,0,8,6,2,0,7,7,0,0,4,2,2,0
2011,Arkansas State,Sun Belt,,13,10,3,0,8,8,0,0,6,6,0,0,6,4,2,0
2011,Army,FBS Independents,,12,3,9,0,0,0,0,0,4,3,1,0,6,0,6,0
2011,Auburn,SEC,West,13,8,5,0,8,4,4,0,7,6,1,0,5,1,4,0
2011,Ball State,Mid-American,West,12,6,6,0,8,4,4,0,5,3,2,0,6,2,4,0
2011,Baylor,Big 12,,13,10,3,0,9,6,3,0,7,7,0,0,4,1,3,0
2011,Boise State,Mountain West,,13,12,1,0,7,6,1,0,6,5,1,0,6,6,0,0
2011,Boston College,ACC,Atlantic,12,4,8,0,8,3,5,0,6,2,4,0,6,2,4,0
2011,Bowling Green,Mid-American,East,12,5,7,0,8,3,5,0,6,2,4,0,6,3,3,0
2011,Buffalo,Mid-American,East,12,3,9,0,8,2,6,0,6,3,3,0,6,0,6,0
2011,BYU,FBS Independents,,13,10,3,0,0,0,0,0,7,6,1,0,4,3,1,0
2011,California,Pac-12,North,13,7,6,0,10,5,5,0,6,5,1,0,6,2,4,0
2011,Central Michigan,Mid-American,West,12,3,9,0,8,2,6,0,5,2,3,0,7,1,6,0
2011,Cincinnati,Big East,,13,10,3,0,7,5,2,0,6,5,1,0,6,4,2,0
2011,Clemson,ACC,Atlantic,14,10,4,0,9,7,2,0,7,7,0,0,5,2,3,0
2011,Colorado,Pac-12,South,13,3,10,0,10,2,8,0,5,1,4,0,7,1,6,0
2011,Colorado State,Mountain West,,12,3,9,0,7,1,6,0,6,1,5,0,5,2,3,0
2011,Connecticut,Big East,,12,5,7,0,7,3,4,0,7,4,3,0,5,1,4,0
2011,Duke,ACC,Coastal,12,3,9,0,8,1,7,0,7,1,6,0,5,2,3,0
2011,East Carolina,Conference USA,East,12,5,7,0,8,4,4,0,6,3,3,0,5,2,3,0
2011,Eastern Michigan,Mid-American,West,12,6,6,0,8,4,4,0,6,5,1,0,6,1,5,0
2011,Florida,SEC,East,13,7,6,0,8,3,5,0,7,5,2,0,4,1,3,0
2011,Florida Atlantic,Sun Belt,,12,1,11,0,8,0,8,0,5,1,4,0,7,0,7,0
2011,Florida International,Sun Belt,,13,8,5,0,8,5,3,0,6,4,2,0,6,4,2,0
2011,Florida State,ACC,Atlantic,13,9,4,0,8,5,3,0,7,5,2,0,5,3,2,0
2011,Fresno State,Western Athletic,,13,4,9,0,7,3,4,0,6,2,4,0,7,2,5,0
2011,Georgia,SEC,East,14,10,4,0,9,7,2,0,7,5,2,0,4,4,0,0
2011,Georgia Tech,ACC,Coastal,13,8,5,0,8,5,3,0,7,5,2,0,5,3,2,0
2011,Hawai'i,Western Athletic,,13,6,7,0,7,3,4,0,7,4,3,0,6,2,4,0
2011,Houston,Conference USA,West,14,13,1,0,9,8,1,0,7,6,1,0,6,6,0,0
2011,Idaho,Western Athletic,,12,2,10,0,7,1,6,0,6,1,5,0,6,1,5,0
2011,Illinois,Big Ten,Leaders,13,7,6,0,8,2,6,0,8,5,3,0,4,1,3,0
2011,Indiana,Big Ten,Leaders,12,1,11,0,8,0,8,0,6,1,5,0,5,0,5,0
2011,Iowa,Big Ten,Legends,13,7,6,0,8,4,4,0,7,6,1,0,5,1,4,0
2011,Iowa State,Big 12,,13,6,7,0,9,3,6,0,6,4,2,0,6,2,4,0
2011,Kansas,Big 12,,12,2,10,0,9,0,9,0,6,2,4,0,5,0,5,0
2011,Kansas State,Big 12,,13,10,3,0,9,7,2,0,7,6,1,0,5,4,1,0
2011,Kent State,Mid-American,East,12,5,7,0,8,4,4,0,6,4,2,0,6,1,5,0
2011,Kentucky,SEC,East,12,5,7,0,8,2,6,0,7,4,3,0,4,0,4,0
2011,Louisiana,Sun Belt,,13,9,4,0,8,6,2,0,5,5,0,0,7,3,4,0
2011,Louisiana Monroe,Sun Belt,,12,4,8,0,8,3,5,0,5,2,3,0,7,2,5,0
2011,Louisiana Tech,Western Athletic,,13,8,5,0,7,6,1,0,5,3,2,0,7,5,2,0
2011,Louisville,Big East,,13,7,6,0,7,5,2,0,6,3,3,0,6,4,2,0
2011,LSU,SEC,West,14,13,1,0,10,9,1,0,6,6,0,0,5,5,0,0
2011,Marshall,Conference USA,East,13,7,6,0,8,5,3,0,5,4,1,0,7,2,5,0
2011,Maryland,ACC,Atlantic,12,2,10,0,8,1,7,0,7,2,5,0,4,0,4,0
2011,Memphis,Conference USA,East,12,2,10,0,8,1,7,0,6,1,5,0,6,1,5,0
2011,Miami,ACC,Coastal,12,6,6,0,8,3,5,0,7,4,3,0,5,2,3,0
2011,Miami (OH),Mid-American,East,12,4,8,0,8,3,5,0,6,3,3,0,6,1,5,0
2011,Michigan,Big Ten,Legends,13,11,2,0,8,6,2,0,8,8,0,0,4,2,2,0
2011,Michigan State,Big Ten,Legends,14,11,3,0,9,7,2,0,7,7,0,0,5,3,2,0
2011,Middle Tennessee,Sun Belt,,12,2,10,0,8,1,7,0,6,1,5,0,6,1,5,0
2011,Minnesota,Big Ten,Legends,12,3,9,0,8,2,6,0,7,3,4,0,5,0,5,0
2011,Mississippi State,SEC,West,13,7,6,0,8,2,6,0,6,3,3,0,6,3,3,0
2011,Missouri,Big 12,,13,8,5,0,9,5,4,0,6,5,1,0,5,1,4,0
2011,Navy,FBS Independents,,12,5,7,0,0,0,0,0,5,2,3,0,6,2,4,0
2011,NC State,ACC,Atlantic,13,8,5,0,8,4,4,0,7,6,1,0,5,1,4,0
2011,Nebraska,Big Ten,Legends,13,9,4,0,8,5,3,0,7,6,1,0,5,3,2,0
2011,Nevada,Western Athletic,,13,7,6,0,7,5,2,0,6,5,1,0,6,2,4,0
2011,New Mexico,Mountain West,,12,1,11,0,7,1,6,0,6,1,5,0,6,0,6,0
2011,New Mexico State,Western Athletic,,13,4,9,0,7,2,5,0,6,2,4,0,7,2,5,0
2011,North Carolina,ACC,Coastal,13,7,6,0,8,3,5,0,7,6,1,0,5,1,4,0
2011,Northern Illinois,Mid-American,West,14,11,3,0,9,8,1,0,6,6,0,0,5,3,2,0
2011,North Texas,Sun Belt,,12,5,7,0,8,4,4,0,6,4,2,0,6,1,5,0
2011,Northwestern,Big Ten,Legends,13,6,7,0,8,3,5,0,6,3,3,0,6,3,3,0
2011,Notre Dame,FBS Independents,,13,8,5,0,0,0,0,0,6,4,2,0,5,3,2,0
2011,Ohio,Mid-American,East,14,10,4,0,9,6,3,0,6,5,1,0,6,4,2,0
2011,Ohio State,Big Ten,Leaders,13,6,7,0,8,3,5,0,7,5,2,0,5,1,4,0
2011,Oklahoma,Big 12,,13,10,3,0,9,6,3,0,6,5,1,0,5,3,2,0
2011,Oklahoma State,Big 12,,13,12,1,0,9,8,1,0,6,6,0,0,6,5,1,0
2011,Ole Miss,SEC,West,12,2,10,0,8,0,8,0,7,1,6,0,5,1,4,0
2011,Oregon,Pac-12,North,14,12,2,0,10,9,1,0,8,7,1,0,4,4,0,0
2011,Oregon State,Pac-12,North,12,3,9,0,9,3,6,0,6,2,4,0,6,1,5,0
2011,Penn State,Big Ten,Leaders,13,9,4,0,8,6,2,0,7,5,2,0,5,4,1,0
2011,Pittsburgh,Big East,,13,6,7,0,7,4,3,0,8,5,3,0,4,1,3,0
2011,Purdue,Big Ten,Leaders,13,7,6,0,8,4,4,0,7,5,2,0,5,1,4,0
2011,Rice,Conference USA,West,12,4,8,0,8,3,5,0,5,4,1,0,7,0,7,0
2011,Rutgers,Big East,,13,9,4,0,7,4,3,0,7,6,1,0,4,1,3,0
2011,San Diego State,Mountain West,,13,8,5,0,7,4,3,0,7,4,3,0,5,4,1,0
2011,San José State,Western Athletic,,12,5,7,0,7,3,4,0,5,3,2,0,7,2,5,0
2011,SMU,Conference USA,West,13,8,5,0,8,5,3,0,6,5,1,0,6,2,4,0
2011,South Carolina,SEC,East,13,11,2,0,8,6,2,0,7,6,1,0,4,3,1,0
2011,Southern Mississippi,Conference USA,East,14,12,2,0,9,7,2,0,6,6,0,0,7,5,2,0
2011,South Florida,Big East,,12,5,7,0,7,1,6,0,7,3,4,0,5,2,3,0
2011,Stanford,Pac-12,North,13,11,2,0,9,8,1,0,7,6,1,0,5,5,0,0
2011,Syracuse,Big East,,12,5,7,0,7,1,6,0,7,4,3,0,5,1,4,0
2011,TCU,Mountain West,,13,11,2,0,7,7,0,0,6,5,1,0,5,4,1,0
2011,Temple,Mid-American,East,13,9,4,0,8,5,3,0,7,5,2,0,5,3,2,0
2011,Tennessee,SEC,East,12,5,7,0,8,1,7,0,8,5,3,0,4,0,4,0
2011,Texas,Big 12,,13,8,5,0,9,4,5,0,6,4,2,0,5,3,2,0
2011,Texas A&M,Big 12,,13,7,6,0,9,4,5,0,7,4,3,0,4,2,2,0
2011,Texas Tech,Big 12,,12,5,7,0,9,2,7,0,6,2,4,0,5,3,2,0
2011,Toledo,Mid-American,West,13,9,4,0,8,7,1,0,6,4,2,0,6,4,2,0
2011,Troy,Sun Belt,,12,3,9,0,8,2,6,0,5,3,2,0,7,0,7,0
2011,Tulane,Conference USA,West,13,2,11,0,8,1,7,0,6,1,5,0,7,1,6,0
2011,Tulsa,Conference USA,West,13,8,5,0,8,7,1,0,6,4,2,0,6,4,2,0
2011,UAB,Conference USA,East,12,3,9,0,8,3,5,0,5,2,3,0,7,1,6,0
2011,UCF,Conference USA,East,12,5,7,0,8,3,5,0,6,5,1,0,6,0,6,0
2011,UCLA,Pac-12,South,14,6,8,0,10,5,5,0,6,5,1,0,7,1,6,0
2011,UNLV,Mountain West,,12,2,10,0,7,1,6,0,5,2,3,0,7,0,7,0
2011,USC,Pac-12,South,12,10,2,0,9,7,2,0,7,6,1,0,5,4,1,0
2011,Utah,Pac-12,South,13,8,5,0,9,4,5,0,6,3,3,0,6,4,2,0
2011,Utah State,Western Athletic,,13,7,6,0,7,5,2,0,6,4,2,0,6,3,3,0
2011,UTEP,Conference USA,West,12,5,7,0,8,2,6,0,6,3,3,0,6,2,4,0
2011,Vanderbilt,SEC,East,13,6,7,0,8,2,6,0,7,5,2,0,5,1,4,0
2011,Virginia,ACC,Coastal,13,8,5,0,8,5,3,0,7,4,3,0,5,4,1,0
2011,Virginia Tech,ACC,Coastal,14,11,3,0,9,7,2,0,6,5,1,0,6,6,0,0
2011,Wake Forest,ACC,Atlantic,13,6,7,0,8,5,3,0,7,4,3,0,5,2,3,0
2011,Washington,Pac-12,North,13,7,6,0,9,5,4,0,7,6,1,0,5,1,4,0
2011,Washington State,Pac-12,North,12,4,8,0,9,2,7,0,6,3,3,0,6,1,5,0
2011,Western Kentucky,Sun Belt,,12,7,5,0,8,7,1,0,6,3,3,0,5,4,1,0
2011,Western Michigan,Mid-American,West,13,7,6,0,8,5,3,0,5,5,0,0,7,2,5,0
2011,West Virginia,Big East,,13,10,3,0,7,5,2,0,7,5,2,0,5,4,1,0
2011,Wisconsin,Big Ten,Leaders,14,11,3,0,9,7,2,0,7,7,0,0,4,2,2,0
2011,Wyoming,Mountain West,,13,8,5,0,7,5,2,0,6,4,2,0,6,4,2,0
2010,Air Force,Mountain West,,13,9,4,0,8,5,3,0,6,5,1,0,6,3,3,0
2010,Akron,Mid-American,East,12,1,11,0,8,1,7,0,6,1,5,0,6,0,6,0
2010,Alabama,SEC,West,13,10,3,0,8,5,3,0,7,6,1,0,5,3,2,0
2010,Arizona,Pac-10,,13,7,6,0,10,5,5,0,7,4,3,0,5,3,2,0
2010,Arizona State,Pac-10,,12,6,6,0,10,4,6,0,6,4,2,0,6,2,4,0
2010,Arkansas,SEC,West,13,10,3,0,8,6,2,0,6,5,1,0,4,3,1,0
2010,Arkansas State,Sun Belt,,12,4,8,0,8,4,4,0,5,3,2,0,7,1,6,0
2010,Army,FBS Independents,,13,7,6,0,0,0,0,0,5,2,3,0,6,5,1,0
2010,Auburn,SEC,West,14,14,0,0,9,9,0,0,8,8,0,0,4,4,0,0
2010,Ball State,Mid-American,West,12,4,8,0,8,3,5,0,6,2,4,0,6,2,4,0
2010,Baylor,Big 12,South,13,7,6,0,8,4,4,0,6,4,2,0,5,3,2,0
2010,Boise State,Western Athletic,,13,12,1,0,8,7,1,0,6,6,0,0,5,4,1,0
2010,Boston College,ACC,Atlantic,13,7,6,0,8,4,4,0,7,4,3,0,5,3,2,0
2010,Bowling Green,Mid-American,East,12,2,10,0,8,1,7,0,5,1,4,0,7,1,6,0
2010,Buffalo,Mid-American,East,12,2,10,0,8,1,7,0,6,1,5,0,6,1,5,0
2010,BYU,Mountain West,,13,7,6,0,9,6,3,0,6,5,1,0,6,1,5,0
2010,California,Pac-10,,12,5,7,0,9,3,6,0,7,4,3,0,5,1,4,0
2010,Central Michigan,Mid-American,West,12,3,9,0,8,2,6,0,5,2,3,0,7,1,6,0
2010,Cincinnati,Big East,,12,4,8,0,7,2,5,0,7,3,4,0,5,1,4,0
2010,Clemson,ACC,Atlantic,13,6,7,0,8,4,4,0,7,5,2,0,5,1,4,0
2010,Colorado,Big 12,North,12,5,7,0,8,2,6,0,6,4,2,0,5,0,5,0
2010,Colorado State,Mountain West,,12,3,9,0,8,2,6,0,5,3,2,0,6,0,6,0
2010,Connecticut,Big East,,13,8,5,0,7,5,2,0,6,6,0,0,6,2,4,0
2010,Duke,ACC,Coastal,12,3,9,0,8,1,7,0,7,2,5,0,5,1,4,0
2010,East Carolina,Conference USA,East,13,6,7,0,8,5,3,0,6,4,2,0,6,2,4,0
2010,Eastern Michigan,Mid-American,West,12,2,10,0,8,2,6,0,5,0,5,0,7,2,5,0
2010,Florida,SEC,East,13,8,5,0,8,4,4,0,7,4,3,0,4,2,2,0
2010,Florida Atlantic,Sun Belt,,12,4,8,0,8,3,5,0,4,2,2,0,7,2,5,0
2010,Florida International,Sun Belt,,13,7,6,0,8,6,2,0,5,3,2,0,7,3,4,0
2010,Florida State,ACC,Atlantic,14,10,4,0,9,6,3,0,7,6,1,0,5,3,2,0
2010,Fresno State,Western Athletic,,13,8,5,0,8,5,3,0,7,5,2,0,5,3,2,0
2010,Georgia,SEC,East,13,6,7,0,8,3,5,0,6,5,1,0,5,1,4,0
2010,Georgia Tech,ACC,Coastal,13,6,7,0,8,4,4,0,6,4,2,0,6,2,4,0
2010,Hawai'i,Western Athletic,,14,10,4,0,8,7,1,0,7,6,1,0,6,4,2,0
2010,Houston,Conference USA,West,12,5,7,0,8,4,4,0,6,3,3,0,6,2,4,0
2010,Idaho,Western Athletic,,13,6,7,0,8,3,5,0,6,4,2,0,7,2,5,0
2010,Illinois,Big Ten,,13,7,6,0,8,4,4,0,6,4,2,0,5,2,3,0
2010,Indiana,Big Ten,,12,5,7,0,8,1,7,0,6,3,3,0,5,2,3,0
2010,Iowa,Big Ten,,13,8,5,0,9,4,5,0,7,5,2,0,5,2,3,0
2010,Iowa State,Big 12,North,12,5,7,0,8,3,5,0,7,4,3,0,4,1,3,0
2010,Kansas,Big 12,North,12,3,9,0,8,1,7,0,7,3,4,0,4,0,4,0
2010,Kansas State,Big 12,North,13,7,6,0,8,3,5,0,6,4,2,0,5,2,3,0
2010,Kent State,Mid-American,East,12,5,7,0,8,4,4,0,6,4,2,0,6,1,5,0
2010,Kentucky,SEC,East,13,6,7,0,8,2,6,0,7,5,2,0,5,1,4,0
2010,Louisiana,Sun Belt,,12,3,9,0,8,3,5,0,5,1,4,0,7,2,5,0
2010,Louisiana Monroe,Sun Belt,,12,5,7,0,8,4,4,0,5,4,1,0,6,1,5,0
2010,Louisiana Tech,Western Athletic,,12,5,7,0,8,4,4,0,6,2,4,0,5,2,3,0
2010,Louisville,Big East,,13,7,6,0,7,3,4,0,7,3,4,0,5,3,2,0
2010,LSU,SEC,West,13,11,2,0,8,6,2,0,7,7,0,0,4,2,2,0
2010,Marshall,Conference USA,East,12,5,7,0,8,4,4,0,6,4,2,0,6,1,5,0
2010,Maryland,ACC,Atlantic,13,9,4,0,8,5,3,0,6,5,1,0,5,2,3,0
2010,Memphis,Conference USA,East,12,1,11,0,8,0,8,0,6,1,5,0,6,0,6,0
2010,Miami,ACC,Coastal,13,7,6,0,8,5,3,0,6,3,3,0,6,4,2,0
2010,Miami (OH),Mid-American,East,14,10,4,0,9,8,1,0,5,4,1,0,7,4,3,0
2010,Michigan,Big Ten,,13,7,6,0,8,3,5,0,7,4,3,0,5,3,2,0
2010,Michigan State,Big Ten,,13,11,2,0,8,7,1,0,7,7,0,0,4,3,1,0
2010,Middle Tennessee,Sun Belt,,13,6,7,0,8,5,3,0,6,3,3,0,6,3,3,0
2010,Minnesota,Big Ten,,12,3,9,0,9,2,7,0,7,1,6,0,5,2,3,0
2010,Mississippi State,SEC,West,13,9,4,0,8,4,4,0,7,5,2,0,5,3,2,0
2010,Missouri,Big 12,North,13,10,3,0,8,6,2,0,6,6,0,0,4,2,2,0
2010,Navy,FBS Independents,,13,9,4,0,0,0,0,0,5,4,1,0,5,3,2,0
2010,NC State,ACC,Atlantic,13,9,4,0,8,5,3,0,6,5,1,0,6,3,3,0
2010,Nebraska,Big 12,North,14,10,4,0,9,6,3,0,7,6,1,0,5,4,1,0
2010,Nevada,Western Athletic,,14,13,1,0,8,7,1,0,7,7,0,0,6,5,1,0
2010,New Mexico,Mountain West,,12,1,11,0,9,1,8,0,6,1,5,0,6,0,6,0
2010,New Mexico State,Western Athletic,,12,2,10,0,8,1,7,0,6,2,4,0,6,0,6,0
2010,North Carolina,ACC,Coastal,13,8,5,0,8,4,4,0,6,3,3,0,5,4,1,0
2010,Northern Illinois,Mid-American,West,14,11,3,0,9,8,1,0,5,5,0,0,7,5,2,0
2010,North Texas,Sun Belt,,12,3,9,0,8,3,5,0,6,0,6,0,6,3,3,0
2010,Northwestern,Big Ten,,13,7,6,0,8,3,5,0,6,3,3,0,6,4,2,0
2010,Notre Dame,FBS Independents,,13,8,5,0,0,0,0,0,7,4,3,0,3,2,1,0
2010,Ohio,Mid-American,East,13,8,5,0,8,6,2,0,6,5,1,0,6,3,3,0
2010,Ohio State,Big Ten,,13,12,1,0,8,7,1,0,8,8,0,0,4,3,1,0
2010,Oklahoma,Big 12,South,14,12,2,0,9,7,2,0,6,6,0,0,5,3,2,0
2010,Oklahoma State,Big 12,South,13,11,2,0,8,6,2,0,7,5,2,0,5,5,0,0
2010,Ole Miss,SEC,West,12,4,8,0,8,1,7,0,7,3,4,0,5,1,4,0
2010,Oregon,Pac-10,,13,12,1,0,10,10,0,0,6,6,0,0,6,6,0,0
2010,Oregon State,Pac-10,,12,5,7,0,10,4,6,0,6,4,2,0,5,1,4,0
2010,Penn State,Big Ten,,13,7,6,0,8,4,4,0,7,5,2,0,4,1,3,0
2010,Pittsburgh,Big East,,13,8,5,0,7,5,2,0,6,4,2,0,6,3,3,0
2010,Purdue,Big Ten,,12,4,8,0,8,2,6,0,7,3,4,0,5,1,4,0
2010,Rice,Conference USA,West,12,4,8,0,8,3,5,0,6,3,3,0,5,1,4,0
2010,Rutgers,Big East,,12,4,8,0,7,1,6,0,7,3,4,0,5,1,4,0
2010,San Diego State,Mountain West,,13,9,4,0,8,5,3,0,7,6,1,0,6,3,3,0
2010,San José State,Western Athletic,,13,1,12,0,8,0,8,0,6,1,5,0,7,0,7,0
2010,SMU,Conference USA,West,14,7,7,0,9,6,3,0,7,4,3,0,7,3,4,0
2010,South Carolina,SEC,East,14,9,5,0,9,5,4,0,7,6,1,0,5,3,2,0
2010,Southern Mississippi,Conference USA,East,13,8,5,0,8,5,3,0,6,4,2,0,6,4,2,0
2010,South Florida,Big East,,13,8,5,0,7,3,4,0,7,4,3,0,5,3,2,0
2010,Stanford,Pac-10,,13,12,1,0,9,8,1,0,6,6,0,0,6,5,1,0
2010,Syracuse,Big East,,13,8,5,0,7,4,3,0,6,2,4,0,6,5,1,0
2010,TCU,Mountain West,,13,13,0,0,10,10,0,0,6,6,0,0,5,5,0,0
2010,Temple,Mid-American,East,12,8,4,0,8,5,3,0,6,5,1,0,6,3,3,0
2010,Tennessee,SEC,East,13,6,7,0,8,3,5,0,7,4,3,0,5,2,3,0
2010,Texas,Big 12,South,12,5,7,0,8,2,6,0,7,2,5,0,3,2,1,0
2010,Texas A&M,Big 12,South,13,9,4,0,8,6,2,0,7,6,1,0,4,3,1,0
2010,Texas Tech,Big 12,South,13,8,5,0,8,3,5,0,6,4,2,0,5,2,3,0
2010,Toledo,Mid-American,West,13,8,5,0,8,7,1,0,6,4,2,0,6,4,2,0
2010,Troy,Sun Belt,,13,8,5,0,8,6,2,0,5,4,1,0,7,3,4,0
2010,Tulane,Conference USA,West,12,4,8,0,8,2,6,0,7,2,5,0,5,2,3,0
2010,Tulsa,Conference USA,West,13,10,3,0,8,6,2,0,6,6,0,0,6,3,3,0
2010,UAB,Conference USA,East,12,4,8,0,8,3,5,0,6,3,3,0,6,1,5,0
2010,UCF,Conference USA,East,14,11,3,0,9,8,1,0,7,5,2,0,6,5,1,0
2010,UCLA,Pac-10,,12,4,8,0,9,2,7,0,6,3,3,0,6,1,5,0
2010,UNLV,Mountain West,,13,2,11,0,9,2,7,0,6,2,4,0,7,0,7,0
2010,USC,Pac-10,,13,8,5,0,10,6,4,0,6,3,3,0,7,5,2,0
2010,Utah,Mountain West,,13,10,3,0,8,7,1,0,6,5,1,0,6,5,1,0
2010,Utah State,Western Athletic,,12,4,8,0,8,2,6,0,6,3,3,0,6,1,5,0
2010,UTEP,Conference USA,West,13,6,7,0,8,3,5,0,6,5,1,0,6,1,5,0
2010,Vanderbilt,SEC,East,12,2,10,0,8,1,7,0,7,1,6,0,5,1,4,0
2010,Virginia,ACC,Coastal,12,4,8,0,8,1,7,0,7,4,3,0,5,0,5,0
2010,Virginia Tech,ACC,Coastal,14,11,3,0,9,9,0,0,7,6,1,0,4,4,0,0
2010,Wake Forest,ACC,Atlantic,12,3,9,0,8,1,7,0,6,2,4,0,6,1,5,0
2010,Washington,Pac-10,,13,7,6,0,10,5,5,0,6,3,3,0,6,3,3,0
2010,Washington State,Pac-10,,12,2,10,0,9,1,8,0,6,1,5,0,6,1,5,0
2010,Western Kentucky,Sun Belt,,12,2,10,0,8,2,6,0,5,0,5,0,7,2,5,0
2010,Western Michigan,Mid-American,West,12,6,6,0,8,5,3,0,6,3,3,0,6,3,3,0
2010,West Virginia,Big East,,13,9,4,0,7,5,2,0,7,6,1,0,5,3,2,0
2010,Wisconsin,Big Ten,,13,11,2,0,11,9,2,0,7,7,0,0,5,4,1,0
2010,Wyoming,Mountain West,,12,3,9,0,8,1,7,0,6,2,4,0,6,1,5,0
2009,Air Force,Mountain West,,13,8,5,0,9,5,4,0,6,5,1,0,6,2,4,0
2009,Akron,Mid-American,East,12,3,9,0,8,2,6,0,6,3,3,0,6,0,6,0
2009,Alabama,SEC,West,14,14,0,0,9,9,0,0,7,7,0,0,4,4,0,0
2009,Arizona,Pac-10,,13,8,5,0,10,6,4,0,6,5,1,0,6,3,3,0
2009,Arizona State,Pac-10,,12,4,8,0,9,2,7,0,7,3,4,0,5,1,4,0
2009,Arkansas,SEC,West,13,8,5,0,8,3,5,0,7,6,1,0,4,0,4,0
2009,Arkansas State,Sun Belt,,12,4,8,0,8,3,5,0,5,3,2,0,7,1,6,0
2009,Army,FBS Independents,,12,5,7,0,0,0,0,0,6,3,3,0,5,2,3,0
2009,Auburn,SEC,West,13,8,5,0,8,3,5,0,8,6,2,0,4,1,3,0
2009,Ball State,Mid-American,West,12,2,10,0,8,2,6,0,6,0,6,0,6,2,4,0
2009,Baylor,Big 12,South,12,4,8,0,8,1,7,0,6,2,4,0,5,2,3,0
2009,Boise State,Western Athletic,,14,14,0,0,8,8,0,0,7,7,0,0,6,6,0,0
2009,Boston College,ACC,Atlantic,13,8,5,0,8,5,3,0,7,6,1,0,5,2,3,0
2009,Bowling Green,Mid-American,East,13,7,6,0,8,6,2,0,6,3,3,0,6,4,2,0
2009,Buffalo,Mid-American,East,12,5,7,0,8,3,5,0,6,2,4,0,6,3,3,0
2009,BYU,Mountain West,,13,11,2,0,9,8,1,0,6,4,2,0,5,5,0,0
2009,California,Pac-10,,13,8,5,0,11,6,5,0,6,4,2,0,6,4,2,0
2009,Central Michigan,Mid-American,West,14,12,2,0,9,9,0,0,5,5,0,0,7,5,2,0
2009,Cincinnati,Big East,,13,12,1,0,7,7,0,0,6,6,0,0,6,6,0,0
2009,Clemson,ACC,Atlantic,14,9,5,0,9,6,3,0,7,6,1,0,5,2,3,0
2009,Colorado,Big 12,North,12,3,9,0,8,2,6,0,6,3,3,0,6,0,6,0
2009,Colorado State,Mountain West,,12,3,9,0,8,0,8,0,6,2,4,0,6,1,5,0
2009,Connecticut,Big East,,13,8,5,0,7,3,4,0,6,4,2,0,6,3,3,0
2009,Duke,ACC,Coastal,12,5,7,0,8,3,5,0,6,2,4,0,6,3,3,0
2009,East Carolina,Conference USA,East,14,9,5,0,9,8,1,0,7,6,1,0,6,3,3,0
2009,Eastern Michigan,Mid-American,West,12,0,12,0,8,0,8,0,5,0,5,0,7,0,7,0
2009,Florida,SEC,East,14,13,1,0,9,8,1,0,7,7,0,0,4,4,0,0
2009,Florida Atlantic,Sun Belt,,12,5,7,0,8,5,3,0,5,2,3,0,7,3,4,0
2009,Florida International,Sun Belt,,12,3,9,0,8,3,5,0,5,2,3,0,7,1,6,0
2009,Florida State,ACC,Atlantic,13,7,6,0,8,4,4,0,6,3,3,0,6,3,3,0
2009,Fresno State,Western Athletic,,13,8,5,0,8,6,2,0,5,4,1,0,7,4,3,0
2009,Georgia,SEC,East,13,8,5,0,8,4,4,0,6,4,2,0,5,3,2,0
2009,Georgia Tech,ACC,Coastal,14,11,3,0,9,8,1,0,6,5,1,0,6,5,1,0
2009,Hawai'i,Western Athletic,,13,6,7,0,8,3,5,0,7,4,3,0,6,2,4,0
2009,Houston,Conference USA,West,14,10,4,0,9,6,3,0,6,6,0,0,7,4,3,0
2009,Idaho,Western Athletic,,13,8,5,0,8,4,4,0,6,4,2,0,6,3,3,0
2009,Illinois,Big Ten,,12,3,9,0,8,2,6,0,6,2,4,0,5,1,4,0
2009,Indiana,Big Ten,,12,4,8,0,8,1,7,0,6,3,3,0,6,1,5,0
2009,Iowa,Big Ten,,13,11,2,0,9,7,2,0,7,6,1,0,5,4,1,0
2009,Iowa State,Big 12,North,13,7,6,0,8,3,5,0,7,4,3,0,5,2,3,0
2009,Kansas,Big 12,North,12,5,7,0,8,1,7,0,6,4,2,0,5,1,4,0
2009,Kansas State,Big 12,North,12,6,6,0,8,4,4,0,6,5,1,0,6,1,5,0
2009,Kent State,Mid-American,East,12,5,7,0,8,4,4,0,6,3,3,0,6,2,4,0
2009,Kentucky,SEC,East,13,7,6,0,8,3,5,0,7,3,4,0,5,4,1,0
2009,Louisiana,Sun Belt,,12,6,6,0,8,4,4,0,6,4,2,0,6,2,4,0
2009,Louisiana Monroe,Sun Belt,,12,6,6,0,8,5,3,0,5,4,1,0,7,2,5,0
2009,Louisiana Tech,Western Athletic,,12,4,8,0,8,3,5,0,5,4,1,0,7,0,7,0
2009,Louisville,Big East,,12,4,8,0,7,1,6,0,6,4,2,0,6,0,6,0
2009,LSU,SEC,West,13,9,4,0,8,5,3,0,7,6,1,0,5,3,2,0
2009,Marshall,Conference USA,East,13,7,6,0,8,4,4,0,6,4,2,0,6,2,4,0
2009,Maryland,ACC,Atlantic,12,2,10,0,8,1,7,0,7,2,5,0,5,0,5,0
2009,Memphis,Conference USA,East,12,2,10,0,8,1,7,0,6,2,4,0,6,0,6,0
2009,Miami,ACC,Coastal,13,9,4,0,8,5,3,0,6,5,1,0,6,4,2,0
2009,Miami (OH),Mid-American,East,12,1,11,0,8,1,7,0,6,1,5,0,6,0,6,0
2009,Michigan,Big Ten,,12,5,7,0,8,1,7,0,8,5,3,0,4,0,4,0
2009,Michigan State,Big Ten,,13,6,7,0,8,4,4,0,7,4,3,0,5,2,3,0
2009,Middle Tennessee,Sun Belt,,13,10,3,0,8,7,1,0,6,5,1,0,6,4,2,0
2009,Minnesota,Big Ten,,13,6,7,0,10,4,6,0,7,4,3,0,5,2,3,0
2009,Mississippi State,SEC,West,12,5,7,0,8,3,5,0,7,2,5,0,5,3,2,0
2009,Missouri,Big 12,North,13,8,5,0,8,4,4,0,6,3,3,0,4,3,1,0
2009,Navy,FBS Independents,,14,10,4,0,0,0,0,0,6,5,1,0,6,3,3,0
2009,NC State,ACC,Atlantic,12,5,7,0,8,2,6,0,8,5,3,0,4,0,4,0
2009,Nebraska,Big 12,North,14,10,4,0,9,6,3,0,7,5,2,0,5,4,1,0
2009,Nevada,Western Athletic,,13,8,5,0,8,7,1,0,6,5,1,0,6,3,3,0
2009,New Mexico,Mountain West,,12,1,11,0,8,1,7,0,6,1,5,0,6,0,6,0
2009,New Mexico State,Western Athletic,,13,3,10,0,8,1,7,0,6,2,4,0,7,1,6,0
2009,North Carolina,ACC,Coastal,13,8,5,0,8,4,4,0,7,5,2,0,5,3,2,0
2009,Northern Illinois,Mid-American,West,13,7,6,0,8,5,3,0,6,5,1,0,6,2,4,0
2009,North Texas,Sun Belt,,12,2,10,0,8,1,7,0,6,1,5,0,6,1,5,0
2009,Northwestern,Big Ten,,13,8,5,0,8,5,3,0,7,5,2,0,5,3,2,0
2009,Notre Dame,FBS Independents,,12,6,6,0,0,0,0,0,8,5,3,0,4,1,3,0
2009,Ohio,Mid-American,East,14,9,5,0,9,7,2,0,6,4,2,0,6,5,1,0
2009,Ohio State,Big Ten,,13,11,2,0,10,8,2,0,7,6,1,0,5,4,1,0
2009,Oklahoma,Big 12,South,13,8,5,0,8,5,3,0,6,6,0,0,4,1,3,0
2009,Oklahoma State,Big 12,South,13,9,4,0,8,6,2,0,8,6,2,0,4,3,1,0
2009,Ole Miss,SEC,West,13,9,4,0,8,4,4,0,7,6,1,0,5,2,3,0
2009,Oregon,Pac-10,,13,10,3,0,12,10,2,0,7,7,0,0,5,3,2,0
2009,Oregon State,Pac-10,,13,8,5,0,11,7,4,0,6,4,2,0,6,4,2,0
2009,Penn State,Big Ten,,13,11,2,0,8,6,2,0,8,6,2,0,4,4,0,0
2009,Pittsburgh,Big East,,13,10,3,0,7,5,2,0,7,6,1,0,5,3,2,0
2009,Purdue,Big Ten,,12,5,7,0,9,4,5,0,7,3,4,0,5,2,3,0
2009,Rice,Conference USA,West,12,2,10,0,8,2,6,0,6,2,4,0,6,0,6,0
2009,Rutgers,Big East,,13,9,4,0,7,3,4,0,7,4,3,0,5,4,1,0
2009,San Diego State,Mountain West,,12,4,8,0,9,2,7,0,6,3,3,0,6,1,5,0
2009,San José State,Western Athletic,,12,2,10,0,8,1,7,0,6,2,4,0,6,0,6,0
2009,SMU,Conference USA,West,13,8,5,0,8,6,2,0,6,5,1,0,6,2,4,0
2009,South Carolina,SEC,East,13,7,6,0,8,3,5,0,7,6,1,0,5,1,4,0
2009,Southern Mississippi,Conference USA,East,13,7,6,0,8,5,3,0,6,6,0,0,6,1,5,0
2009,South Florida,Big East,,13,8,5,0,7,3,4,0,6,4,2,0,6,3,3,0
2009,Stanford,Pac-10,,13,8,5,0,9,6,3,0,7,6,1,0,5,2,3,0
2009,Syracuse,Big East,,12,4,8,0,7,1,6,0,8,4,4,0,4,0,4,0
2009,TCU,Mountain West,,13,12,1,0,8,8,0,0,6,6,0,0,6,6,0,0
2009,Temple,Mid-American,East,13,9,4,0,8,7,1,0,6,5,1,0,6,4,2,0
2009,Tennessee,SEC,East,13,7,6,0,8,4,4,0,8,6,2,0,4,1,3,0
2009,Texas,Big 12,South,14,13,1,0,9,9,0,0,6,6,0,0,5,5,0,0
2009,Texas A&M,Big 12,South,13,6,7,0,8,3,5,0,7,5,2,0,4,1,3,0
2009,Texas Tech,Big 12,South,13,9,4,0,8,5,3,0,7,6,1,0,4,1,3,0
2009,Toledo,Mid-American,West,12,5,7,0,8,3,5,0,6,3,3,0,6,2,4,0
2009,Troy,Sun Belt,,13,9,4,0,8,8,0,0,5,5,0,0,7,4,3,0
2009,Tulane,Conference USA,West,12,3,9,0,8,1,7,0,6,2,4,0,6,1,5,0
2009,Tulsa,Conference USA,West,12,5,7,0,8,3,5,0,6,2,4,0,6,3,3,0
2009,UAB,Conference USA,East,12,5,7,0,8,4,4,0,5,3,2,0,7,2,5,0
2009,UCF,Conference USA,East,13,8,5,0,8,6,2,0,7,6,1,0,5,2,3,0
2009,UCLA,Pac-10,,13,7,6,0,10,4,6,0,6,4,2,0,6,2,4,0
2009,UNLV,Mountain West,,12,5,7,0,9,3,6,0,7,4,3,0,5,1,4,0
2009,USC,Pac-10,,13,9,4,0,10,6,4,0,6,4,2,0,6,4,2,0
2009,Utah,Mountain West,,13,10,3,0,10,7,3,0,6,6,0,0,6,3,3,0
2009,Utah State,Western Athletic,,12,4,8,0,8,3,5,0,5,3,2,0,7,1,6,0
2009,UTEP,Conference USA,West,12,4,8,0,8,3,5,0,6,3,3,0,6,1,5,0
2009,Vanderbilt,SEC,East,12,2,10,0,8,0,8,0,6,1,5,0,6,1,5,0
2009,Virginia,ACC,Coastal,12,3,9,0,8,2,6,0,7,1,6,0,5,2,3,0
2009,Virginia Tech,ACC,Coastal,13,10,3,0,8,6,2,0,6,5,1,0,5,4,1,0
2009,Wake Forest,ACC,Atlantic,12,5,7,0,8,3,5,0,7,4,3,0,5,1,4,0
2009,Washington,Pac-10,,12,5,7,0,9,4,5,0,7,5,2,0,5,0,5,0
2009,Washington State,Pac-10,,12,1,11,0,9,0,9,0,6,1,5,0,6,0,6,0
2009,Western Kentucky,Sun Belt,,12,0,12,0,8,0,8,0,6,0,6,0,6,0,6,0
2009,Western Michigan,Mid-American,West,12,5,7,0,8,4,4,0,5,3,2,0,7,2,5,0
2009,West Virginia,Big East,,13,9,4,0,7,5,2,0,7,7,0,0,5,2,3,0
2009,Wisconsin,Big Ten,,13,10,3,0,8,5,3,0,7,6,1,0,5,3,2,0
2009,Wyoming,Mountain West,,13,7,6,0,8,4,4,0,6,3,3,0,6,3,3,0
2008,Air Force,Mountain West,,13,8,5,0,8,5,3,0,6,3,3,0,6,5,1,0
2008,Akron,Mid-American,East,12,5,7,0,8,3,5,0,5,1,4,0,7,4,3,0
2008,Alabama,SEC,West,14,12,2,0,9,8,1,0,7,7,0,0,4,4,0,0
2008,Arizona,Pac-10,,13,8,5,0,11,6,5,0,7,5,2,0,5,2,3,0
2008,Arizona State,Pac-10,,12,5,7,0,10,4,6,0,7,4,3,0,5,1,4,0
2008,Arkansas,SEC,West,12,5,7,0,8,2,6,0,6,3,3,0,5,1,4,0
2008,Arkansas State,Sun Belt,,12,6,6,0,7,4,3,0,5,4,1,0,7,2,5,0
2008,Army,FBS Independents,,12,3,9,0,0,0,0,0,6,2,4,0,5,1,4,0
2008,Auburn,SEC,West,12,5,7,0,8,2,6,0,7,4,3,0,5,1,4,0
2008,Ball State,Mid-American,West,14,12,2,0,9,8,1,0,6,6,0,0,6,6,0,0
2008,Baylor,Big 12,South,12,4,8,0,8,2,6,0,7,4,3,0,5,0,5,0
2008,Boise State,Western Athletic,,13,12,1,0,8,8,0,0,6,6,0,0,6,6,0,0
2008,Boston College,ACC,Atlantic,14,9,5,0,9,5,4,0,7,5,2,0,5,4,1,0
2008,Bowling Green,Mid-American,East,12,6,6,0,8,4,4,0,5,1,4,0,7,5,2,0
2008,Buffalo,Mid-American,East,14,8,6,0,9,6,3,0,6,4,2,0,6,3,3,0
2008,BYU,Mountain West,,13,10,3,0,11,8,3,0,6,6,0,0,6,4,2,0
2008,California,Pac-10,,13,9,4,0,11,8,3,0,7,7,0,0,5,1,4,0
2008,Central Michigan,Mid-American,West,13,8,5,0,8,6,2,0,5,4,1,0,7,4,3,0
2008,Cincinnati,Big East,,14,11,3,0,7,6,1,0,6,6,0,0,7,5,2,0
2008,Clemson,ACC,Atlantic,13,7,6,0,8,4,4,0,7,5,2,0,4,2,2,0
2008,Colorado,Big 12,North,12,5,7,0,8,2,6,0,6,4,2,0,5,0,5,0
2008,Colorado State,Mountain West,,13,7,6,0,9,4,5,0,6,4,2,0,5,2,3,0
2008,Connecticut,Big East,,13,8,5,0,7,3,4,0,6,4,2,0,6,3,3,0
2008,Duke,ACC,Coastal,12,4,8,0,8,1,7,0,7,3,4,0,5,1,4,0
2008,East Carolina,Conference USA,East,14,9,5,0,9,7,2,0,5,4,1,0,7,4,3,0
2008,Eastern Michigan,Mid-American,West,12,3,9,0,8,2,6,0,5,2,3,0,7,1,6,0
2008,Florida,SEC,East,14,13,1,0,9,8,1,0,7,6,1,0,4,4,0,0
2008,Florida Atlantic,Sun Belt,,13,7,6,0,7,4,3,0,5,4,1,0,7,2,5,0
2008,Florida International,Sun Belt,,12,5,7,0,7,3,4,0,5,3,2,0,7,2,5,0
2008,Florida State,ACC,Atlantic,13,9,4,0,8,5,3,0,8,5,3,0,4,3,1,0
2008,Fresno State,Western Athletic,,13,7,6,0,8,4,4,0,5,2,3,0,7,5,2,0
2008,Georgia,SEC,East,13,10,3,0,8,6,2,0,6,4,2,0,5,5,0,0
2008,Georgia Tech,ACC,Coastal,13,9,4,0,8,5,3,0,7,6,1,0,5,3,2,0
2008,Hawai'i,Western Athletic,,14,7,7,0,8,5,3,0,7,5,2,0,6,2,4,0
2008,Houston,Conference USA,West,13,8,5,0,8,6,2,0,6,5,1,0,6,2,4,0
2008,Idaho,Western Athletic,,12,2,10,0,8,1,7,0,6,2,4,0,6,0,6,0
2008,Illinois,Big Ten,,12,5,7,0,8,3,5,0,6,4,2,0,5,1,4,0
2008,Indiana,Big Ten,,12,3,9,0,8,1,7,0,8,3,5,0,4,0,4,0
2008,Iowa,Big Ten,,13,9,4,0,8,5,3,0,7,6,1,0,5,2,3,0
2008,Iowa State,Big 12,North,12,2,10,0,8,0,8,0,6,2,4,0,6,0,6,0
2008,Kansas,Big 12,North,13,8,5,0,8,4,4,0,7,5,2,0,4,1,3,0
2008,Kansas State,Big 12,North,12,5,7,0,8,2,6,0,7,4,3,0,5,1,4,0
2008,Kent State,Mid-American,East,12,4,8,0,8,3,5,0,6,2,4,0,6,2,4,0
2008,Kentucky,SEC,East,13,7,6,0,8,2,6,0,7,4,3,0,5,2,3,0
2008,Louisiana,Sun Belt,,12,6,6,0,7,5,2,0,5,4,1,0,7,2,5,0
2008,Louisiana Monroe,Sun Belt,,12,4,8,0,7,3,4,0,5,3,2,0,6,1,5,0
2008,Louisiana Tech,Western Athletic,,13,8,5,0,8,5,3,0,6,5,1,0,6,2,4,0
2008,Louisville,Big East,,12,5,7,0,7,1,6,0,8,4,4,0,4,1,3,0
2008,LSU,SEC,West,13,8,5,0,8,3,5,0,8,5,3,0,4,2,2,0
2008,Marshall,Conference USA,East,12,4,8,0,8,3,5,0,6,3,3,0,6,1,5,0
2008,Maryland,ACC,Atlantic,13,8,5,0,8,4,4,0,7,6,1,0,5,1,4,0
2008,Memphis,Conference USA,East,13,6,7,0,8,4,4,0,7,4,3,0,5,2,3,0
2008,Miami,ACC,Coastal,13,7,6,0,8,4,4,0,6,4,2,0,6,3,3,0
2008,Miami (OH),Mid-American,East,12,2,10,0,8,1,7,0,6,1,5,0,6,1,5,0
2008,Michigan,Big Ten,,12,3,9,0,9,2,7,0,7,2,5,0,5,1,4,0
2008,Michigan State,Big Ten,,13,9,4,0,9,6,3,0,7,6,1,0,5,3,2,0
2008,Middle Tennessee,Sun Belt,,12,5,7,0,7,3,4,0,5,4,1,0,7,1,6,0
2008,Minnesota,Big Ten,,13,7,6,0,8,3,5,0,7,4,3,0,5,3,2,0
2008,Mississippi State,SEC,West,12,4,8,0,8,2,6,0,6,4,2,0,6,0,6,0
2008,Missouri,Big 12,North,14,10,4,0,9,5,4,0,6,5,1,0,4,3,1,0
2008,Navy,FBS Independents,,13,8,5,0,0,0,0,0,6,4,2,0,5,3,2,0
2008,NC State,ACC,Atlantic,13,6,7,0,8,4,4,0,7,4,3,0,5,2,3,0
2008,Nebraska,Big 12,North,13,9,4,0,8,5,3,0,8,6,2,0,4,2,2,0
2008,Nevada,Western Athletic,,13,7,6,0,8,5,3,0,6,3,3,0,6,4,2,0
2008,New Mexico,Mountain West,,12,4,8,0,9,3,6,0,6,3,3,0,6,1,5,0
2008,New Mexico State,Western Athletic,,12,3,9,0,8,1,7,0,6,1,5,0,6,2,4,0
2008,North Carolina,ACC,Coastal,13,8,5,0,8,4,4,0,7,5,2,0,5,3,2,0
2008,Northern Illinois,Mid-American,West,13,6,7,0,8,5,3,0,6,4,2,0,6,2,4,0
2008,North Texas,Sun Belt,,12,1,11,0,7,0,7,0,5,0,5,0,7,1,6,0
2008,Northwestern,Big Ten,,13,9,4,0,8,5,3,0,7,5,2,0,5,4,1,0
2008,Notre Dame,FBS Independents,,13,7,6,0,0,0,0,0,6,4,2,0,6,2,4,0
2008,Ohio,Mid-American,East,12,4,8,0,8,3,5,0,5,2,3,0,7,2,5,0
2008,Ohio State,Big Ten,,13,10,3,0,9,7,2,0,7,6,1,0,5,4,1,0
2008,Oklahoma,Big 12,South,14,12,2,0,9,8,1,0,6,6,0,0,5,5,0,0
2008,Oklahoma State,Big 12,South,13,9,4,0,8,5,3,0,7,6,1,0,5,3,2,0
2008,Ole Miss,SEC,West,13,9,4,0,8,5,3,0,7,5,2,0,5,3,2,0
2008,Oregon,Pac-10,,13,10,3,0,10,8,2,0,6,5,1,0,6,4,2,0
2008,Oregon State,Pac-10,,13,9,4,0,11,7,4,0,6,5,1,0,6,3,3,0
2008,Penn State,Big Ten,,13,11,2,0,10,8,2,0,7,7,0,0,5,4,1,0
2008,Pittsburgh,Big East,,13,9,4,0,7,5,2,0,6,4,2,0,6,5,1,0
2008,Purdue,Big Ten,,12,4,8,0,9,2,7,0,7,4,3,0,5,0,5,0
2008,Rice,Conference USA,West,13,10,3,0,8,7,1,0,6,6,0,0,6,3,3,0
2008,Rutgers,Big East,,13,8,5,0,7,5,2,0,7,5,2,0,5,2,3,0
2008,San Diego State,Mountain West,,12,2,10,0,8,1,7,0,6,2,4,0,6,0,6,0
2008,San José State,Western Athletic,,12,6,6,0,8,4,4,0,6,3,3,0,6,3,3,0
2008,SMU,Conference USA,West,12,1,11,0,8,0,8,0,6,1,5,0,6,0,6,0
2008,South Carolina,SEC,East,13,7,6,0,8,4,4,0,7,5,2,0,5,2,3,0
2008,Southern Mississippi,Conference USA,East,13,7,6,0,8,4,4,0,6,3,3,0,6,3,3,0
2008,South Florida,Big East,,13,8,5,0,7,2,5,0,6,4,2,0,6,3,3,0
2008,Stanford,Pac-10,,12,5,7,0,10,4,6,0,5,4,1,0,7,1,6,0
2008,Syracuse,Big East,,12,3,9,0,7,1,6,0,6,2,4,0,6,1,5,0
2008,TCU,Mountain West,,13,11,2,0,9,8,1,0,6,6,0,0,6,4,2,0
2008,Temple,Mid-American,East,12,5,7,0,8,4,4,0,5,3,2,0,7,2,5,0
2008,Tennessee,SEC,East,12,5,7,0,8,3,5,0,7,4,3,0,5,1,4,0
2008,Texas,Big 12,South,13,12,1,0,8,7,1,0,7,7,0,0,4,3,1,0
2008,Texas A&M,Big 12,South,12,4,8,0,8,2,6,0,7,2,5,0,5,2,3,0
2008,Texas Tech,Big 12,South,13,11,2,0,8,7,1,0,7,7,0,0,5,4,1,0
2008,Toledo,Mid-American,West,12,3,9,0,8,2,6,0,6,1,5,0,6,2,4,0
2008,Troy,Sun Belt,,13,8,5,0,7,6,1,0,5,5,0,0,7,3,4,0
2008,Tulane,Conference USA,West,12,2,10,0,8,1,7,0,6,2,4,0,6,0,6,0
2008,Tulsa,Conference USA,West,14,11,3,0,9,7,2,0,7,6,1,0,6,4,2,0
2008,UAB,Conference USA,East,12,4,8,0,8,3,5,0,5,2,3,0,7,2,5,0
2008,UCF,Conference USA,East,12,4,8,0,8,3,5,0,6,2,4,0,6,2,4,0
2008,UCLA,Pac-10,,12,4,8,0,10,3,7,0,7,3,4,0,5,1,4,0
2008,UNLV,Mountain West,,12,5,7,0,9,3,6,0,7,4,3,0,5,1,4,0
2008,USC,Pac-10,,13,12,1,0,11,10,1,0,6,6,0,0,6,5,1,0
2008,Utah,Mountain West,,13,13,0,0,10,10,0,0,6,6,0,0,6,6,0,0
2008,Utah State,Western Athletic,,12,3,9,0,8,3,5,0,6,3,3,0,6,0,6,0
2008,UTEP,Conference USA,West,12,5,7,0,8,4,4,0,6,3,3,0,6,2,4,0
2008,Vanderbilt,SEC,East,13,7,6,0,8,4,4,0,6,3,3,0,6,3,3,0
2008,Virginia,ACC,Coastal,12,5,7,0,8,3,5,0,7,4,3,0,5,1,4,0
2008,Virginia Tech,ACC,Coastal,14,10,4,0,9,6,3,0,6,6,0,0,5,2,3,0
2008,Wake Forest,ACC,Atlantic,13,8,5,0,8,4,4,0,7,5,2,0,5,2,3,0
2008,Washington,Pac-10,,12,0,12,0,10,0,10,0,7,0,7,0,5,0,5,0
2008,Washington State,Pac-10,,13,2,11,0,9,1,8,0,7,2,5,0,6,0,6,0
2008,Western Kentucky,FBS Independents,,12,2,10,0,0,0,0,0,5,1,4,0,7,1,6,0
2008,Western Michigan,Mid-American,West,13,9,4,0,8,6,2,0,6,6,0,0,6,3,3,0
2008,West Virginia,Big East,,13,9,4,0,7,5,2,0,7,6,1,0,5,2,3,0
2008,Wisconsin,Big Ten,,13,7,6,0,8,3,5,0,7,5,2,0,5,2,3,0
2008,Wyoming,Mountain West,,12,4,8,0,8,1,7,0,7,3,4,0,5,1,4,0
